"","Player","Country","Start","End","Matches","Innings","Dismissals","Caught","CaughtFielder","CaughtBehind","Stumped","MaxDismissalsInnings"
"1","KC Sangakkara (Asia/ICC/SL)",NA,2000,2015,404,397,501,402,19,383,99,5
"2","AC Gilchrist (AUS/ICC)",NA,1996,2008,287,286,472,417,0,417,55,6
"3","MS Dhoni (Asia/INDIA)",NA,2004,2019,350,345,444,321,0,321,123,6
"4","MV Boucher (Afr/SA)",NA,1998,2011,295,291,425,403,1,402,22,6
"5","Moin Khan ","Pakistan",1990,2004,219,217,287,214,0,214,73,5
"6","BB McCullum ","New Zealand",2002,2016,260,257,277,262,35,227,15,5
"7","IA Healy ","Australia",1988,1997,168,168,233,194,0,194,39,4
"8","Mushfiqur Rahim ","Bangladesh",2006,2020,218,217,225,181,2,179,44,5
"9","Rashid Latif ","Pakistan",1992,2003,166,164,220,182,0,182,38,5
"10","DPMD Jayawardene (Asia/SL)",NA,1998,2015,448,443,218,218,218,0,0,4
"11","R Dravid (Asia/ICC/INDIA)",NA,1996,2011,344,341,210,196,124,72,14,4
"12","RS Kaluwitharana ","Sri Lanka",1990,2004,189,188,207,132,1,131,75,5
"13","PJL Dujon ","West Indies",1981,1991,169,168,204,183,0,183,21,4
"14","JC Buttler ","England",2012,2019,142,138,202,171,0,171,31,6
"15","RD Jacobs ","West Indies",1996,2004,147,145,189,160,0,160,29,6
"16","Kamran Akmal ","Pakistan",2002,2017,157,154,188,157,1,156,31,5
"17","D Ramdin ","West Indies",2005,2016,139,137,188,181,0,181,7,5
"18","AB de Villiers (Afr/SA)",NA,2005,2018,228,223,181,176,83,93,5,5
"19","BJ Haddin ","Australia",2001,2015,126,124,181,170,0,170,11,5
"20","AJ Stewart ","England",1989,2003,170,169,174,159,11,148,15,6
"21","Q de Kock ","South Africa",2013,2020,121,116,173,164,0,164,9,6
"22","A Flower ","Zimbabwe",1992,2003,213,212,173,141,8,133,32,5
"23","DJ Richardson ","South Africa",1991,1998,122,121,165,148,0,148,17,5
"24","RT Ponting (AUS/ICC)",NA,1995,2012,375,372,160,160,160,0,0,3
"25","M Azharuddin ","India",1985,2000,334,332,156,156,156,0,0,4
"26","NR Mongia ","India",1994,2000,140,139,154,110,0,110,44,5
"27","BRM Taylor ","Zimbabwe",2004,2020,196,196,154,125,29,96,29,5
"28","T Taibu (Afr/ZIM)",NA,2001,2012,150,150,147,114,2,112,33,4
"29","AC Parore ","New Zealand",1992,2002,179,178,141,116,5,111,25,5
"30","Sarfaraz Ahmed ","Pakistan",2007,2019,116,114,140,116,0,116,24,6
"31","SR Tendulkar ","India",1989,2012,463,456,140,140,140,0,0,4
"32","LRPL Taylor ","New Zealand",2006,2020,232,228,139,139,139,0,0,4
"33","Younis Khan ","Pakistan",2000,2015,265,260,135,135,130,5,0,4
"34","SP Fleming (ICC/NZ)",NA,1994,2007,280,276,133,133,133,0,0,4
"35","JH Kallis (Afr/ICC/SA)",NA,1996,2014,328,324,131,131,131,0,0,3
"36","M Muralitharan (Asia/ICC/SL)",NA,1993,2011,350,347,130,130,130,0,0,3
"37","V Kohli ","India",2008,2020,248,246,128,128,128,0,0,3
"38","AR Border ","Australia",1979,1994,273,270,127,127,127,0,0,3
"39","Shahid Afridi (Asia/ICC/PAK)",NA,1996,2015,398,392,127,127,127,0,0,2
"40","Khaled Mashud ","Bangladesh",1995,2006,126,126,126,91,0,91,35,5
"41","TM Dilshan ","Sri Lanka",1999,2016,330,325,124,123,118,5,1,3
"42","CH Gayle (ICC/WI)",NA,1999,2019,301,294,124,124,124,0,0,3
"43","RW Marsh ","Australia",1971,1984,92,92,124,120,0,120,4,5
"44","ST Jayasuriya (Asia/SL)",NA,1989,2011,445,441,123,123,123,0,0,3
"45","CL Hooper ","West Indies",1987,2003,227,225,120,120,120,0,0,4
"46","BC Lara (ICC/WI)",NA,1990,2007,299,296,120,120,120,0,0,3
"47","L Ronchi (AUS/NZ)",NA,2008,2017,85,83,117,105,0,105,12,4
"48","MS Wade ","Australia",2012,2017,94,94,117,108,0,108,9,5
"49","Inzamam-ul-Haq (Asia/PAK)",NA,1991,2007,378,373,113,113,113,0,0,3
"50","SR Waugh ","Australia",1986,2002,325,324,111,111,111,0,0,3
"51","RS Mahanama ","Sri Lanka",1986,1999,213,212,109,109,109,0,0,3
"52","PD Collingwood ","England",2001,2011,197,197,108,108,108,0,0,3
"53","HH Gibbs ","South Africa",1996,2010,248,246,108,108,108,0,0,3
"54","SM Pollock (Afr/ICC/SA)",NA,1996,2008,303,300,108,108,108,0,0,2
"55","ME Waugh ","Australia",1988,2002,244,243,108,108,108,0,0,3
"56","MJ Clarke ","Australia",2003,2015,245,243,106,106,106,0,0,4
"57","MEK Hussey ","Australia",2004,2012,185,184,105,105,105,0,0,3
"58","JN Rhodes ","South Africa",1992,2003,245,242,105,105,105,0,0,5
"59","GC Smith (Afr/SA)",NA,2002,2013,197,196,105,105,105,0,0,4
"60","NJ O'Brien ","Ireland",2006,2018,103,99,104,90,8,82,14,5
"61","Saleem Yousuf ","Pakistan",1982,1990,86,86,103,81,0,81,22,4
"62","SK Raina ","India",2005,2018,226,223,102,102,102,0,0,3
"63","SC Ganguly (Asia/INDIA)",NA,1992,2007,311,309,100,100,100,0,0,3
"64","IVA Richards ","West Indies",1975,1991,187,186,100,100,100,0,0,3
"65","Shoaib Malik ","Pakistan",1999,2019,287,285,98,98,98,0,0,2
"66","CZ Harris ","New Zealand",1990,2004,250,247,96,96,96,0,0,4
"67","PA de Silva ","Sri Lanka",1984,2003,308,307,95,95,95,0,0,3
"68","HP Tillakaratne ","Sri Lanka",1986,2003,200,199,95,89,50,39,6,5
"69","Yuvraj Singh (Asia/INDIA)",NA,2000,2017,304,298,94,94,94,0,0,3
"70","SD Hope ","West Indies",2016,2020,78,75,93,83,0,83,10,5
"71","V Sehwag (Asia/ICC/INDIA)",NA,1999,2013,251,246,93,93,93,0,0,3
"72","MJ Guptill ","New Zealand",2009,2020,183,181,91,91,91,0,0,4
"73","Ijaz Ahmed ","Pakistan",1986,2000,250,249,90,90,90,0,0,3
"74","KS More ","India",1984,1993,94,93,90,63,0,63,27,5
"75","Umar Akmal ","Pakistan",2009,2019,121,119,90,77,32,45,13,5
"76","TWM Latham ","New Zealand",2012,2020,99,97,89,82,26,56,7,5
"77","Mohammad Shahzad ","Afghanistan",2009,2019,84,83,89,64,1,63,25,5
"78","DL Vettori (ICC/NZ)",NA,1997,2015,295,289,88,88,88,0,0,2
"79","Wasim Akram ","Pakistan",1984,2003,356,352,88,88,88,0,0,3
"80","HM Amla ","South Africa",2008,2019,181,176,87,87,87,0,0,4
"81","GW Flower ","Zimbabwe",1992,2010,221,220,86,86,86,0,0,2
"82","IDS Smith ","New Zealand",1980,1992,98,97,86,81,1,80,5,3
"83","A Kumble (Asia/INDIA)",NA,1990,2007,271,268,85,85,85,0,0,2
"84","Mohammad Hafeez ","Pakistan",2003,2019,218,216,85,85,85,0,0,2
"85","NJ Astle ","New Zealand",1995,2007,223,219,83,83,83,0,0,3
"86","EJG Morgan (ENG/IRE)",NA,2006,2020,236,230,83,83,80,3,0,3
"87","GC Wilson ","Ireland",2007,2019,105,101,83,73,24,49,10,4
"88","JP Duminy ","South Africa",2004,2019,199,195,82,82,82,0,0,3
"89","A Symonds ","Australia",1998,2009,198,196,82,82,82,0,0,4
"90","F du Plessis ","South Africa",2011,2019,143,141,81,81,81,0,0,3
"91","Saleem Malik ","Pakistan",1982,1999,283,277,81,81,80,1,0,4
"92","SK Warne (AUS/ICC)",NA,1993,2005,194,193,80,80,80,0,0,3
"93","UDU Chandana ","Sri Lanka",1994,2007,147,146,79,79,79,0,0,3
"94","MJ Prior ","England",2004,2011,68,68,79,71,2,69,8,6
"95","RG Sharma ","India",2007,2020,224,223,77,77,77,0,0,3
"96","ADR Campbell ","Zimbabwe",1992,2003,188,187,76,76,74,2,0,3
"97","MH Cross ","Scotland",2014,2019,52,51,75,71,0,71,4,6
"98","RB Richardson ","West Indies",1983,1996,224,222,75,75,75,0,0,4
"99","JE Root ","England",2013,2020,146,142,74,74,74,0,0,3
"100","JC Adams ","West Indies",1992,2001,127,127,73,68,42,26,5,5
"101","DJ Bravo ","West Indies",2004,2014,164,161,73,73,73,0,0,3
"102","S Chanderpaul ","West Indies",1994,2011,268,264,73,73,73,0,0,2
"103","WJ Cronje ","South Africa",1992,2000,188,186,73,73,73,0,0,2
"104","Javed Miandad ","Pakistan",1975,1996,233,229,73,71,70,1,2,3
"105","SB Styris ","New Zealand",1999,2011,188,185,73,73,73,0,0,3
"106","E Chigumbura (Afr/ZIM)",NA,2004,2018,213,212,72,72,72,0,0,4
"107","GO Jones (ENG/PNG)",NA,2004,2014,51,51,72,68,0,68,4,5
"108","Harbhajan Singh (Asia/INDIA)",NA,1998,2015,236,231,71,71,71,0,0,3
"109","N Kapil Dev ","India",1978,1994,225,222,71,71,71,0,0,3
"110","KD Karthik ","India",2004,2019,94,94,71,64,29,35,7,4
"111","H Masakadza ","Zimbabwe",2001,2019,209,209,71,71,71,0,0,2
"112","MS Atapattu ","Sri Lanka",1990,2007,268,266,70,70,70,0,0,3
"113","MG Bevan ","Australia",1994,2004,232,230,69,69,69,0,0,3
"114","DR Martyn ","Australia",1992,2006,208,205,69,69,69,0,0,3
"115","A Bagai ","Canada",2003,2013,62,62,68,59,1,58,9,4
"116","CO Browne ","West Indies",1995,2005,46,46,68,59,0,59,9,5
"117","ML Hayden (AUS/ICC)",NA,1993,2008,161,158,68,68,68,0,0,2
"118","DJG Sammy ","West Indies",2004,2015,126,124,67,67,67,0,0,3
"119","SPD Smith ","Australia",2010,2020,125,125,67,67,67,0,0,3
"120","SO Tikolo (Afr/KENYA)",NA,1996,2014,135,135,67,67,67,0,0,3
"121","CL Cairns (ICC/NZ)",NA,1991,2006,215,214,66,66,66,0,0,3
"122","LD Chandimal ","Sri Lanka",2010,2019,146,143,66,59,28,31,7,4
"123","MD Crowe ","New Zealand",1982,1995,143,141,66,66,66,0,0,3
"124","Misbah-ul-Haq ","Pakistan",2002,2015,162,160,66,66,66,0,0,4
"125","C Kieswetter ","England",2010,2013,46,45,65,53,1,52,12,5
"126","GJ Maxwell ","Australia",2012,2019,110,110,65,65,65,0,0,4
"127","GA Hick ","England",1991,2001,120,119,64,64,64,0,0,3
"128","Mahmudullah ","Bangladesh",2007,2020,188,187,64,64,64,0,0,3
"129","KJ O'Brien ","Ireland",2006,2020,145,141,64,64,64,0,0,3
"130","WTS Porterfield ","Ireland",2006,2020,139,134,64,64,64,0,0,3
"131","SR Watson ","Australia",2002,2015,190,189,64,64,64,0,0,2
"132","A Ranatunga ","Sri Lanka",1982,1999,269,268,63,63,63,0,0,3
"133","DJ Cullinan ","South Africa",1993,2000,138,135,62,62,62,0,0,3
"134","S Dhawan ","India",2010,2020,136,134,62,62,62,0,0,4
"135","G Kirsten ","South Africa",1993,2003,185,183,62,61,60,1,1,3
"136","Mashrafe Mortaza (Asia/BDESH)",NA,2001,2020,220,220,62,62,62,0,0,2
"137","NLTC Perera ","Sri Lanka",2009,2020,164,160,62,62,62,0,0,2
"138","Wasim Bari ","Pakistan",1973,1984,51,50,62,52,0,52,10,4
"139","AL Logie ","West Indies",1981,1993,158,158,61,61,61,0,0,3
"140","DA Miller ","South Africa",2010,2020,132,128,61,61,61,0,0,3
"141","KA Pollard ","West Indies",2007,2020,113,111,61,61,61,0,0,4
"142","AJ Finch ","Australia",2013,2020,126,126,60,60,60,0,0,3
"143","WPUJC Vaas (Asia/SL)",NA,1994,2008,322,320,60,60,60,0,0,2
"144","KS Williamson ","New Zealand",2010,2020,151,150,60,60,60,0,0,3
"145","DL Haynes ","West Indies",1978,1994,238,236,59,59,59,0,0,2
"146","A Jadeja ","India",1992,2000,196,195,59,59,59,0,0,2
"147","RA Jadeja ","India",2009,2020,165,164,58,58,58,0,0,2
"148","Mohammad Yousuf (Asia/PAK)",NA,1998,2010,288,285,58,58,58,0,0,2
"149","MA Ouma ","Kenya",2004,2014,80,80,58,48,5,43,10,5
"150","KO Otieno ","Kenya",1996,2009,90,90,57,43,3,40,14,4
"151","AJ Strauss ","England",2003,2011,127,127,57,57,57,0,0,3
"152","MA Taylor ","Australia",1989,1997,113,113,56,56,56,0,0,4
"153","RA Harper ","West Indies",1983,1996,105,105,55,55,55,0,0,3
"154","M Kaif ","India",2002,2006,125,122,55,55,55,0,0,4
"155","Mohammad Nabi ","Afghanistan",2009,2019,124,121,55,55,55,0,0,3
"156","TD Paine ","Australia",2009,2018,35,34,55,51,0,51,4,5
"157","PV Simmons ","West Indies",1987,1999,143,143,55,55,55,0,0,4
"158","DA Warner ","Australia",2009,2020,123,123,55,55,55,0,0,2
"159","IR Bell ","England",2004,2015,161,160,54,54,54,0,0,3
"160","DM Jones ","Australia",1984,1994,164,164,54,54,54,0,0,2
"161","B Lee ","Australia",2000,2012,221,217,54,54,54,0,0,3
"162","Tamim Iqbal ","Bangladesh",2007,2020,207,206,54,54,54,0,0,2
"163","JM Anderson ","England",2002,2015,194,192,53,53,53,0,0,3
"164","AD Mathews ","Sri Lanka",2008,2020,217,213,53,53,53,0,0,3
"165","JR Murray ","West Indies",1992,1999,55,55,53,46,2,44,7,3
"166","AB Agarkar ","India",1998,2007,191,188,52,52,52,0,0,2
"167","CS Baugh ","West Indies",2003,2012,47,46,51,39,0,39,12,4
"168","JDP Oram ","New Zealand",2001,2012,160,159,51,51,51,0,0,2
"169","JG Wright ","New Zealand",1978,1992,149,147,51,51,51,0,0,2
"170","JO Holder ","West Indies",2013,2020,115,112,50,50,50,0,0,2
"171","MN Samuels ","West Indies",2000,2018,207,207,50,50,50,0,0,2
"172","Shakib Al Hasan ","Bangladesh",2006,2019,206,205,50,50,50,0,0,3
"173","WU Tharanga (Asia/SL)",NA,2005,2019,235,228,50,50,50,0,0,3
"174","P Utseya ","Zimbabwe",2004,2015,164,164,50,50,50,0,0,2
"175","SC Williams ","Zimbabwe",2005,2020,133,132,50,50,50,0,0,3
"176","Aamer Sohail ","Pakistan",1990,2000,156,154,49,49,49,0,0,2
"177","AP Gurusinha ","Sri Lanka",1985,1996,147,147,49,49,47,2,0,2
"178","WB Phillips ","Australia",1982,1986,48,48,49,42,0,42,7,4
"179","ME Trescothick ","England",2000,2006,123,121,49,49,45,4,0,3
"180","KC Wessels (AUS/SA)",NA,1983,1994,109,106,49,49,49,0,0,4
"181","RP Arnold ","Sri Lanka",1997,2007,180,179,48,48,48,0,0,2
"182","GJ Bailey ","Australia",2012,2016,90,90,48,48,48,0,0,3
"183","AM Rahane ","India",2011,2018,90,87,48,48,48,0,0,2
"184","J Smits ","Netherlands",2003,2009,38,38,48,41,0,41,7,4
"185","AT Carey ","Australia",2018,2020,36,36,47,42,0,42,5,5
"186","N Dickwella ","Sri Lanka",2014,2019,52,52,47,38,0,38,9,4
"187","A Flintoff (ENG/ICC)",NA,1999,2009,141,140,47,47,47,0,0,3
"188","RC Russell ","England",1987,1998,40,40,47,41,0,41,6,3
"189","KMDN Kulasekara ","Sri Lanka",2003,2017,184,181,46,46,46,0,0,3
"190","MDKJ Perera ","Sri Lanka",2013,2020,101,100,46,43,17,26,3,4
"191","HH Streak (Afr/ZIM)",NA,1993,2005,189,188,46,46,46,0,0,2
"192","CEL Ambrose ","West Indies",1988,2000,176,175,45,45,45,0,0,3
"193","DC Boon ","Australia",1984,1995,181,181,45,45,45,0,0,2
"194","GA Gooch ","England",1976,1995,125,125,45,45,45,0,0,2
"195","CG Greenidge ","West Indies",1975,1991,128,127,45,45,45,0,0,2
"196","RR Sarwan ","West Indies",2000,2013,181,176,45,45,45,0,0,2
"197","PR Stirling ","Ireland",2008,2020,117,113,45,45,45,0,0,3
"198","BA Stokes ","England",2011,2019,95,92,45,45,45,0,0,3
"199","D Williams ","West Indies",1988,1997,36,35,45,35,0,35,10,4
"200","DI Gower ","England",1978,1991,114,114,44,44,44,0,0,3
"201","NV Knight ","England",1996,2003,100,100,44,44,44,0,0,2
"202","CD McMillan ","New Zealand",1997,2007,197,193,44,44,44,0,0,2
"203","DO Obuya ","Kenya",2001,2012,74,74,44,39,16,23,5,4
"204","CR Woakes ","England",2011,2020,101,97,44,44,44,0,0,4
"205","Z Khan (Asia/INDIA)",NA,2000,2012,200,197,43,43,43,0,0,3
"206","CO Obuya ","Kenya",2001,2014,104,104,43,43,43,0,0,3
"207","RL Powell ","West Indies",1999,2005,109,107,43,43,43,0,0,3
"208","CMW Read ","England",2000,2006,36,35,43,41,0,41,2,5
"209","CR Ervine ","Zimbabwe",2010,2019,93,92,42,42,42,0,0,4
"210","BM McMillan ","South Africa",1991,1998,78,77,42,42,42,0,0,3
"211","KD Mills ","New Zealand",2001,2015,170,169,42,42,42,0,0,3
"212","Saeed Anwar ","Pakistan",1989,2003,247,242,42,42,42,0,0,3
"213","V Sibanda (Afr/ZIM)",NA,2003,2016,127,127,42,42,42,0,0,2
"214","K Srikkanth ","India",1981,1992,146,145,42,42,42,0,0,2
"215","GP Thorpe ","England",1993,2002,82,81,42,42,42,0,0,3
"216","NL McCullum ","New Zealand",2009,2015,84,83,41,41,41,0,0,4
"217","KR Rutherford ","New Zealand",1985,1995,121,121,41,41,41,0,0,4
"218","L Vincent ","New Zealand",2001,2007,102,100,41,41,39,2,0,2
"219","JV Coney ","New Zealand",1979,1987,88,86,40,40,40,0,0,3
"220","N Hussain ","England",1989,2003,88,88,40,40,40,0,0,2
"221","KP Pietersen (ENG/ICC)",NA,2004,2013,136,135,40,40,40,0,0,2
"222","Saqlain Mushtaq ","Pakistan",1995,2003,169,166,40,40,40,0,0,2
"223","RJ Shastri ","India",1981,1992,150,148,40,40,40,0,0,2
"224","Sikandar Raza ","Zimbabwe",2013,2020,100,99,40,40,40,0,0,3
"225","SV Carlisle ","Zimbabwe",1995,2005,111,111,39,39,39,0,0,3
"226","VVS Laxman ","India",1998,2006,86,85,39,39,39,0,0,4
"227","CH Lloyd ","West Indies",1973,1985,87,87,39,39,39,0,0,3
"228","BKG Mendis ","Sri Lanka",2016,2020,76,75,39,39,37,2,0,3
"229","PA Patel ","India",2003,2012,38,36,39,30,0,30,9,4
"230","TG Southee ","New Zealand",2008,2020,143,142,39,39,39,0,0,3
"231","TE Blain ","New Zealand",1986,1994,38,38,38,37,1,36,1,4
"232","DSBP Kuruppu ","Sri Lanka",1983,1990,54,54,38,30,4,26,8,4
"233","DL Murray ","West Indies",1973,1980,26,26,38,37,0,37,1,4
"234","HDRL Thirimanne ","Sri Lanka",2010,2019,127,125,38,38,38,0,0,2
"235","Azhar Mahmood ","Pakistan",1996,2007,143,140,37,37,37,0,0,2
"236","JM Bairstow ","England",2011,2020,77,74,37,35,22,13,2,4
"237","AG Cremer ","Zimbabwe",2009,2018,96,95,37,37,37,0,0,2
"238","GD McGrath (AUS/ICC)",NA,1993,2007,250,248,37,37,37,0,0,3
"239","S Matsikenyeri ","Zimbabwe",2002,2015,113,113,37,37,37,0,0,3
"240","Najibullah Zadran ","Afghanistan",2012,2019,67,66,37,37,37,0,0,3
"241","BKV Prasad ","India",1994,2001,161,160,37,37,37,0,0,3
"242","Sabbir Rahman ","Bangladesh",2014,2019,66,65,37,37,37,0,0,3
"243","RG Twose ","New Zealand",1995,2001,87,87,37,37,37,0,0,2
"244","DB Vengsarkar ","India",1976,1991,129,127,37,37,37,0,0,3
"245","CL White ","Australia",2005,2018,91,90,37,37,37,0,0,3
"246","Babar Azam ","Pakistan",2015,2019,74,73,36,36,36,0,0,2
"247","J Botha (Afr/SA)",NA,2005,2012,78,77,36,36,36,0,0,3
"248","IT Botham ","England",1976,1992,116,116,36,36,36,0,0,2
"249","AN Cook ","England",2006,2014,92,91,36,36,36,0,0,2
"250","HH Dippenaar (Afr/SA)",NA,1999,2007,107,106,36,36,34,2,0,3
"251","GH Dockrell ","Ireland",2010,2019,87,85,36,36,36,0,0,2
"252","G Gambhir ","India",2003,2013,147,144,36,36,36,0,0,3
"253","GB Hogg ","Australia",1996,2008,123,121,36,36,36,0,0,2
"254","Imran Khan ","Pakistan",1974,1992,175,172,36,36,36,0,0,3
"255","SMH Kirmani ","India",1976,1986,49,48,36,27,0,27,9,5
"256","GJ Whittall ","Zimbabwe",1993,2003,147,146,36,36,36,0,0,4
"257","Abdul Razzaq (Asia/PAK)",NA,1996,2011,265,262,35,35,35,0,0,2
"258","RS Bopara ","England",2007,2015,120,118,35,35,35,0,0,2
"259","MJ Greatbatch ","New Zealand",1988,1996,84,84,35,35,34,1,0,2
"260","MG Johnson ","Australia",2005,2015,153,152,35,35,35,0,0,2
"261","L Klusener ","South Africa",1996,2004,171,169,35,35,35,0,0,2
"262","Mohammad Ashraful (Asia/BDESH)",NA,2001,2013,177,177,35,35,35,0,0,2
"263","Waqar Younis ","Pakistan",1989,2003,262,259,35,35,35,0,0,2
"264","DM Bravo ","West Indies",2009,2020,113,110,34,34,34,0,0,3
"265","HDPK Dharmasena ","Sri Lanka",1994,2004,141,140,34,34,34,0,0,2
"266","Nasir Hossain ","Bangladesh",2011,2018,65,65,34,34,34,0,0,2
"267","PL Taylor ","Australia",1987,1992,83,83,34,34,34,0,0,2
"268","N Boje (Afr/SA)",NA,1995,2005,115,113,33,33,33,0,0,2
"269","RW Chakabva ","Zimbabwe",2008,2020,41,41,33,29,12,17,4,5
"270","CJ Chibhabha ","Zimbabwe",2005,2020,104,103,33,33,33,0,0,2
"271","NH Fairbrother ","England",1987,1999,75,75,33,33,33,0,0,3
"272","KM Jadhav ","India",2014,2020,73,72,33,33,33,0,0,3
"273","RS Kalpage ","Sri Lanka",1992,1999,86,86,33,33,33,0,0,3
"274","JM Kemp (Afr/SA)",NA,2001,2007,85,84,33,33,33,0,0,3
"275","Ramiz Raja ","Pakistan",1985,1997,198,193,33,33,33,0,0,2
"276","RR Singh ","India",1989,2001,136,135,33,33,33,0,0,2
"277","CJO Smith ","Scotland",2006,2009,27,26,33,22,0,22,11,5
"278","Soumya Sarkar ","Bangladesh",2014,2019,55,54,33,33,33,0,0,4
"279","Abdur Razzak ","Bangladesh",2004,2014,153,153,32,32,32,0,0,2
"280","MM Ali ","England",2014,2020,102,99,32,32,32,0,0,3
"281","Ghulam Shabber ","United Arab Emirates",2017,2019,23,23,32,30,0,30,2,4
"282","J Srinath ","India",1991,2003,229,227,32,32,32,0,0,2
"283","RW Taylor ","England",1973,1984,27,27,32,26,0,26,6,4
"284","TA Boult ","New Zealand",2012,2020,90,90,31,31,31,0,0,2
"285","DL Houghton ","Zimbabwe",1983,1997,63,63,31,29,19,10,2,4
"286","CK Kapugedera ","Sri Lanka",2006,2017,102,100,31,31,31,0,0,2
"287","AJ Lamb ","England",1982,1992,122,122,31,31,31,0,0,2
"288","SL Malinga ","Sri Lanka",2004,2019,226,220,31,31,31,0,0,2
"289","GR Marsh ","Australia",1986,1992,117,117,31,31,31,0,0,2
"290","M Morkel (Afr/SA)",NA,2007,2018,117,114,31,31,31,0,0,3
"291","JJ Roy ","England",2015,2020,87,85,31,31,31,0,0,2
"292","DR Smith ","West Indies",2004,2015,105,103,31,31,31,0,0,2
"293","R Ashwin ","India",2010,2017,111,110,30,30,30,0,0,3
"294","RG de Alwis ","Sri Lanka",1983,1988,31,31,30,27,0,27,3,5
"295","J Garner ","West Indies",1977,1987,98,98,30,30,30,0,0,3
"296","LK Germon ","New Zealand",1994,1997,37,37,30,21,0,21,9,4
"297","MA Holding ","West Indies",1976,1987,102,102,30,30,30,0,0,3
"298","SS Karim ","India",1997,2000,34,34,30,27,0,27,3,4
"299","WK Lees ","New Zealand",1979,1983,31,31,30,28,0,28,2,4
"300","CS MacLeod ","Scotland",2008,2019,66,65,30,30,30,0,0,4
"301","Mohammad Rizwan ","Pakistan",2015,2019,32,32,30,29,12,17,1,4
"302","Mushtaq Ahmed ","Pakistan",1989,2003,144,144,30,30,30,0,0,2
"303","M Ntini (ICC/SA)",NA,1998,2009,173,171,30,30,30,0,0,2
"304","CS Pandit ","India",1986,1992,36,36,30,15,0,15,15,4
"305","AU Rashid ","England",2009,2020,100,97,30,30,30,0,0,3
"306","PA Strang ","Zimbabwe",1994,2001,95,94,30,30,30,0,0,2
"307","Aftab Ahmed ","Bangladesh",2004,2010,85,85,29,29,29,0,0,3
"308","TM Alderman ","Australia",1981,1991,65,65,29,29,29,0,0,3
"309","Alok Kapali ","Bangladesh",2002,2011,69,69,29,29,29,0,0,2
"310","RD Berrington ","Scotland",2008,2019,78,77,29,29,29,0,0,2
"311","PR Downton ","England",1977,1988,28,28,29,26,0,26,3,4
"312","AJ Hall ","South Africa",1999,2007,88,87,29,29,29,0,0,2
"313","WW Hinds ","West Indies",1999,2010,119,119,29,29,29,0,0,2
"314","DJ Hussey ","Australia",2008,2013,69,69,29,29,29,0,0,2
"315","R Mutumbami ","Zimbabwe",2014,2020,36,36,29,24,2,22,5,4
"316","GP Swann ","England",2000,2013,79,78,29,29,29,0,0,3
"317","DC Thomas ","West Indies",2009,2013,21,21,29,23,0,23,6,3
"318","Ahmed Shehzad ","Pakistan",2009,2017,81,80,28,28,28,0,0,2
"319","PW Borren ","Netherlands",2006,2014,58,58,28,28,28,0,0,3
"320","JJ Crowe ","New Zealand",1983,1990,75,74,28,28,28,0,0,2
"321","AA Donald ","South Africa",1991,2003,164,162,28,28,28,0,0,2
"322","GC Dyer ","Australia",1986,1988,23,23,28,24,0,24,4,4
"323","GJ Hopkins ","New Zealand",2004,2010,25,23,28,27,0,27,1,5
"324","Mohammad Rafique (Asia/BDESH)",NA,1995,2007,125,125,28,28,28,0,0,2
"325","TM Odoyo (Afr/KENYA)",NA,1996,2014,136,136,28,28,28,0,0,2
"326","RJ Peterson ","South Africa",2002,2014,79,79,28,28,28,0,0,2
"327","LMP Simmons ","West Indies",2006,2015,68,68,28,28,26,2,0,2
"328","DW Steyn (Afr/SA)",NA,2005,2019,125,124,28,28,28,0,0,2
"329","BA Young ","New Zealand",1990,1999,74,73,28,28,22,6,0,3
"330","KLT Arthurton ","West Indies",1988,1999,105,104,27,27,27,0,0,2
"331","F Behardien ","South Africa",2013,2018,59,58,27,27,27,0,0,2
"332","SCJ Broad ","England",2006,2016,121,121,27,27,27,0,0,2
"333","CRD Fernando (Asia/SL)",NA,2001,2012,147,146,27,27,27,0,0,3
"334","Sir RJ Hadlee ","New Zealand",1973,1990,115,113,27,27,27,0,0,2
"335","AD Hales ","England",2014,2019,70,68,27,27,27,0,0,2
"336","KJ Hughes ","Australia",1977,1985,97,96,27,27,27,0,0,2
"337","EC Joyce (ENG/IRE)",NA,2006,2018,78,75,27,27,27,0,0,2
"338","B Kumar ","India",2012,2019,114,113,27,27,27,0,0,2
"339","Liton Das ","Bangladesh",2015,2020,36,36,27,24,16,8,3,4
"340","CJ McDermott ","Australia",1985,1996,138,138,27,27,27,0,0,1
"341","MR Marsh ","Australia",2011,2020,57,57,27,27,27,0,0,4
"342","Mohammed Shami ","India",2013,2020,77,76,27,27,27,0,0,2
"343","M Prabhakar ","India",1984,1996,130,128,27,27,27,0,0,3
"344","MJ Santner ","New Zealand",2015,2020,72,71,27,27,27,0,0,2
"345","MA Starc ","Australia",2010,2020,91,91,27,27,27,0,0,2
"346","Wahab Riaz ","Pakistan",2008,2019,89,88,27,27,27,0,0,2
"347","CA Walsh ","West Indies",1985,2000,205,204,27,27,27,0,0,1
"348","NW Bracken ","Australia",2001,2009,116,116,26,26,26,0,0,2
"349","PAJ DeFreitas ","England",1987,1997,103,103,26,26,26,0,0,2
"350","JEC Franklin ","New Zealand",2001,2013,110,109,26,26,26,0,0,2
"351","Habibul Bashar ","Bangladesh",1995,2007,111,111,26,26,26,0,0,2
"352","Imran Nazir ","Pakistan",1999,2009,79,78,26,26,26,0,0,3
"353","DS Lehmann ","Australia",1996,2005,117,116,26,26,26,0,0,3
"354","MF Maharoof ","Sri Lanka",2004,2016,109,107,26,26,26,0,0,2
"355","LE Plunkett ","England",2005,2019,89,87,26,26,26,0,0,2
"356","AG Prince (Afr/SA)",NA,2002,2007,52,51,26,26,26,0,0,4
"357","RA Smith ","England",1988,1996,71,71,26,26,26,0,0,2
"358","GP Wickramasinghe ","Sri Lanka",1990,2002,134,134,26,26,26,0,0,2
"359","CB Wishart ","Zimbabwe",1996,2005,90,90,26,26,26,0,0,2
"360","B Zuiderent ","Netherlands",1996,2011,57,57,26,26,26,0,0,2
"361","W Barresi ","Netherlands",2010,2019,32,32,25,17,4,13,8,3
"362","D Gough (ENG/ICC)",NA,1994,2006,159,157,25,25,25,0,0,1
"363","JR Hopes ","Australia",2005,2010,84,83,25,25,25,0,0,2
"364","Imran Tahir ","South Africa",2011,2019,107,104,25,25,25,0,0,2
"365","DT Johnston ","Ireland",2006,2013,67,65,25,25,25,0,0,2
"366","DJ Nash ","New Zealand",1992,2002,81,80,25,25,25,0,0,3
"367","DW Randall ","England",1976,1985,49,49,25,25,25,0,0,2
"368","PR Reiffel ","Australia",1992,1999,92,92,25,25,25,0,0,2
"369","Saeed Ajmal ","Pakistan",2008,2015,113,112,25,25,25,0,0,1
"370","MP Vaughan ","England",2001,2007,86,85,25,25,25,0,0,3
"371","Aaqib Javed ","Pakistan",1988,1998,163,159,24,24,24,0,0,1
"372","Asghar Afghan ","Afghanistan",2009,2019,111,108,24,24,24,0,0,2
"373","V Dahiya ","India",2000,2001,19,19,24,19,0,19,5,3
"374","SS Dighe ","India",2000,2001,23,23,24,19,0,19,5,4
"375","NM Hauritz ","Australia",2002,2011,58,57,24,24,24,0,0,2
"376","S Viswanath ","India",1985,1988,22,22,24,17,0,17,7,5
"377","Wasim Raja ","Pakistan",1973,1985,54,52,24,24,24,0,0,2
"378","M Amarnath ","India",1975,1989,85,84,23,23,23,0,0,2
"379","SL Campbell ","West Indies",1994,2001,90,90,23,23,23,0,0,3
"380","GS Chappell ","Australia",1971,1983,74,72,23,23,23,0,0,2
"381","DD Ebrahim ","Zimbabwe",2001,2005,82,82,23,23,23,0,0,2
"382","AH Jones ","New Zealand",1987,1995,87,87,23,23,23,0,0,2
"383","Junaid Siddique ","Bangladesh",2007,2011,54,54,23,23,22,1,0,3
"384","GR Larsen ","New Zealand",1990,1999,121,121,23,23,23,0,0,1
"385","S Lee ","Australia",1995,2001,45,44,23,23,23,0,0,2
"386","SV Manjrekar ","India",1988,1996,74,74,23,23,23,0,0,2
"387","GRJ Matthews ","Australia",1984,1993,59,59,23,23,23,0,0,3
"388","PJ Moor ","Zimbabwe",2014,2019,49,48,23,22,6,16,1,4
"389","JDS Neesham ","New Zealand",2013,2020,63,63,23,23,23,0,0,2
"390","PA Nixon ","England",2007,2007,19,19,23,20,0,20,3,2
"391","DN Patel ","New Zealand",1987,1997,75,75,23,23,23,0,0,2
"392","SW Poynter ","Ireland",2014,2019,21,21,23,22,3,19,1,4
"393","PL Symcox ","South Africa",1993,1999,80,80,23,23,23,0,0,2
"394","TJ Zoehrer ","Australia",1986,1994,22,22,23,21,0,21,2,4
"395","Zulqarnain ","Pakistan",1985,1989,16,14,23,18,0,18,5,4
"396","Afsar Zazai ","Afghanistan",2014,2017,17,16,22,20,0,20,2,3
"397","J Charles ","West Indies",2012,2016,48,48,22,21,11,10,1,2
"398","MW Gatting ","England",1977,1993,92,92,22,22,22,0,0,2
"399","SM Gavaskar ","India",1974,1987,108,107,22,22,22,0,0,4
"400","AF Giles ","England",1997,2005,62,62,22,22,22,0,0,3
"401","SE Marsh ","Australia",2008,2019,73,73,22,22,22,0,0,2
"402","PL Mommsen ","Scotland",2010,2017,44,43,22,22,22,0,0,2
"403","C Munro ","New Zealand",2013,2019,57,57,22,22,22,0,0,2
"404","SP O'Donnell ","Australia",1985,1991,87,87,22,22,22,0,0,2
"405","HH Pandya ","India",2016,2019,54,53,22,22,22,0,0,2
"406","K Rabada ","South Africa",2015,2019,75,73,22,22,22,0,0,2
"407","Rashid Khan ","Afghanistan",2015,2019,71,68,22,22,22,0,0,3
"408","RR Rossouw ","South Africa",2014,2016,36,35,22,22,22,0,0,4
"409","MN Waller ","Zimbabwe",2009,2018,79,79,22,22,22,0,0,1
"410","RGD Willis ","England",1973,1984,64,64,22,22,22,0,0,2
"411","UT Yadav ","India",2010,2018,75,73,22,22,22,0,0,3
"412","Abdul Qadir ","Pakistan",1983,1993,104,102,21,21,21,0,0,2
"413","DL Bairstow ","England",1979,1984,21,21,21,17,0,17,4,3
"414","Fakhar Zaman ","Pakistan",2017,2019,46,45,21,21,21,0,0,2
"415","JP Faulkner ","Australia",2013,2017,69,69,21,21,21,0,0,1
"416","Imrul Kayes ","Bangladesh",2008,2018,78,78,21,21,21,0,0,2
"417","ND McKenzie ","South Africa",2000,2009,64,64,21,21,21,0,0,3
"418","Manzoor Elahi ","Pakistan",1984,1995,54,54,21,21,21,0,0,2
"419","AF Milne ","New Zealand",2012,2017,40,39,21,21,21,0,0,3
"420","D Mongia ","India",2001,2007,57,56,21,21,21,0,0,3
"421","TM Moody ","Australia",1987,1999,76,76,21,21,21,0,0,2
"422","Mudassar Nazar ","Pakistan",1977,1989,122,119,21,21,21,0,0,2
"423","A Nel ","South Africa",2001,2008,79,77,21,21,21,0,0,2
"424","IK Pathan ","India",2004,2012,120,118,21,21,21,0,0,1
"425","MSK Prasad ","India",1998,1999,17,17,21,14,0,14,7,5
"426","KAJ Roach ","West Indies",2008,2019,92,90,21,21,21,0,0,2
"427","Samiullah Shinwari ","Afghanistan",2009,2019,84,84,21,21,21,0,0,2
"428","OA Shah ","England",2001,2009,71,71,21,21,21,0,0,2
"429","RV Uthappa ","India",2006,2015,46,44,21,19,15,4,2,3
"430","AR White ","Ireland",2006,2014,61,61,21,21,21,0,0,2
"431","AR Whittall ","Zimbabwe",1996,2000,63,63,21,21,21,0,0,3
"432","DJ Willey ","England",2015,2019,46,45,21,21,21,0,0,2
"433","Ashraf Ali ","Pakistan",1980,1985,16,16,20,17,0,17,3,3
"434","A Balbirnie ","Ireland",2010,2020,67,65,20,20,20,0,0,4
"435","GB Brent ","Zimbabwe",1996,2008,70,70,20,20,20,0,0,2
"436","TT Bresnan ","England",2006,2015,85,84,20,20,20,0,0,2
"437","AF Buurman ","Netherlands",2007,2011,17,17,20,17,2,15,3,3
"438","CK Coventry ","Zimbabwe",2003,2015,39,39,20,19,19,0,1,1
"439","DN Crookes ","South Africa",1994,2000,32,32,20,20,20,0,0,2
"440","DM de Silva ","Sri Lanka",2016,2020,45,45,20,20,20,0,0,2
"441","M Dillon ","West Indies",1997,2005,108,107,20,20,20,0,0,2
"442","JS Foster ","England",2001,2002,11,11,20,13,0,13,7,3
"443","MW Goodwin ","Zimbabwe",1998,2000,71,71,20,20,20,0,0,2
"444","JK Kamande ","Kenya",1999,2011,86,86,20,20,20,0,0,2
"445","H Klaasen ","South Africa",2018,2020,17,17,20,17,6,11,3,4
"446","CC Lewis ","England",1990,1998,53,53,20,20,20,0,0,2
"447","DA Minors ","Bermuda",2006,2007,20,20,20,16,4,12,4,3
"448","RS Morton ","West Indies",2002,2010,56,55,20,20,20,0,0,3
"449","Rubel Hossain ","Bangladesh",2009,2019,101,100,20,20,20,0,0,2
"450","Salman Butt ","Pakistan",2004,2010,78,77,20,20,20,0,0,2
"451","Shoaib Akhtar (Asia/ICC/PAK)",NA,1998,2011,163,162,20,20,20,0,0,2
"452","NS Sidhu ","India",1987,1998,136,135,20,20,20,0,0,2
"453","LPC Silva ","Sri Lanka",1999,2011,75,73,20,20,20,0,0,3
"454","SAR Silva ","Sri Lanka",1984,1985,20,20,20,17,0,17,3,3
"455","JE Taylor ","West Indies",2003,2017,90,88,20,20,20,0,0,2
"456","DR Tuffey ","New Zealand",2000,2010,94,92,20,20,20,0,0,3
"457","BJ Watling ","New Zealand",2010,2018,28,28,20,20,6,14,0,3
"458","Akram Raza ","Pakistan",1989,1995,49,49,19,19,19,0,0,2
"459","AJ Bichel ","Australia",1997,2004,67,66,19,19,19,0,0,2
"460","JG Bracewell ","New Zealand",1983,1990,53,52,19,19,19,0,0,3
"461","BL Cairns ","New Zealand",1974,1985,78,77,19,19,19,0,0,2
"462","EJ Chatfield ","New Zealand",1979,1989,114,112,19,19,19,0,0,2
"463","SS Cottrell ","West Indies",2015,2020,35,33,19,19,19,0,0,3
"464","XJ Doherty ","Australia",2010,2015,60,60,19,19,19,0,0,2
"465","JE Emburey ","England",1980,1993,61,61,19,19,19,0,0,2
"466","JM How ","New Zealand",2005,2011,41,40,19,19,19,0,0,4
"467","NC Johnson ","Zimbabwe",1998,2000,48,48,19,19,19,0,0,2
"468","CJ Jordan ","England",2013,2020,34,34,19,19,19,0,0,2
"469","SB Joshi ","India",1996,2001,69,68,19,19,19,0,0,2
"470","RAS Lakmal ","Sri Lanka",2009,2019,85,83,19,19,19,0,0,1
"471","AR McBrine ","Ireland",2014,2020,45,44,19,19,19,0,0,3
"472","Mohammad Sami ","Pakistan",2001,2015,87,86,19,19,19,0,0,2
"473","JF Mooney ","Ireland",2006,2015,64,62,19,19,19,0,0,2
"474","DK Morrison ","New Zealand",1987,1996,96,96,19,19,19,0,0,2
"475","Naeem Islam ","Bangladesh",2008,2014,59,59,19,19,19,0,0,2
"476","Nawroz Mangal ","Afghanistan",2009,2016,49,49,19,19,19,0,0,2
"477","CJ Nevin ","New Zealand",2000,2003,37,36,19,16,2,14,3,3
"478","Rahmat Shah ","Afghanistan",2013,2019,73,70,19,19,19,0,0,2
"479","SMSM Senanayake ","Sri Lanka",2012,2015,49,48,19,19,19,0,0,3
"480","I Sharma ","India",2007,2016,80,78,19,19,19,0,0,1
"481","MC Snedden ","New Zealand",1980,1990,93,92,19,19,19,0,0,1
"482","AO Suji ","Kenya",1996,2008,60,60,19,19,19,0,0,2
"483","V Yadav ","India",1992,1994,19,19,19,12,0,12,7,3
"484","Asif Mujtaba ","Pakistan",1986,1996,66,66,18,18,18,0,0,3
"485","AR Cusack ","Ireland",2007,2015,59,55,18,18,18,0,0,2
"486","PG Fulton ","New Zealand",2004,2009,49,48,18,18,18,0,0,2
"487","IJ Gould ","England",1983,1983,18,18,18,15,0,15,3,3
"488","SO Hetmyer ","West Indies",2017,2020,45,43,18,18,15,3,0,3
"489","AC Hudson ","South Africa",1991,1997,89,88,18,18,18,0,0,2
"490","AN Kervezee ","Netherlands",2006,2012,39,39,18,18,18,0,0,3
"491","GF Lawson ","Australia",1980,1989,79,79,18,18,18,0,0,2
"492","MA Leask ","Scotland",2014,2019,34,34,18,18,18,0,0,3
"493","S Madan Lal ","India",1974,1987,67,65,18,18,18,0,0,2
"494","RS Madugalle ","Sri Lanka",1979,1988,63,63,18,18,18,0,0,2
"495","JP Maher ","Australia",1998,2003,26,26,18,18,10,8,0,3
"496","Maninder Singh ","India",1983,1993,59,58,18,18,18,0,0,2
"497","HJH Marshall ","New Zealand",2003,2007,66,65,18,18,18,0,0,3
"498","NO Miller ","West Indies",2008,2018,50,48,18,18,18,0,0,3
"499","A Nehra (Asia/INDIA)",NA,2001,2011,120,120,18,18,18,0,0,2
"500","HM Nicholls ","New Zealand",2015,2020,49,48,18,18,18,0,0,2
"501","RR Patel ","Kenya",2008,2014,39,39,18,18,18,0,0,2
"502","Raqibul Hasan ","Bangladesh",2008,2011,55,55,18,18,18,0,0,2
"503","WP Saha ","India",2010,2014,9,8,18,17,0,17,1,4
"504","SA Thomson ","New Zealand",1990,1996,56,56,18,18,18,0,0,2
"505","MA Vermeulen ","Zimbabwe",2000,2009,43,43,18,18,18,0,0,3
"506","DP Viljoen ","Zimbabwe",1997,2001,53,53,18,18,18,0,0,2
"507","SC Williams ","West Indies",1994,1999,57,57,18,18,18,0,0,3
"508","LJ Wright ","England",2007,2014,50,50,18,18,18,0,0,2
"509","Ahmed Raza ","United Arab Emirates",2014,2020,31,31,17,17,17,0,0,3
"510","JJ Bumrah ","India",2016,2020,64,64,17,17,17,0,0,2
"511","JM Davison ","Canada",2003,2011,32,32,17,17,17,0,0,2
"512","GD Elliott ","New Zealand",2008,2016,83,83,17,17,17,0,0,2
"513","TJ Friend ","Zimbabwe",2000,2004,51,51,17,17,17,0,0,2
"514","Haris Sohail ","Pakistan",2013,2019,41,40,17,17,17,0,0,2
"515","IJ Harvey ","Australia",1997,2004,73,72,17,17,17,0,0,2
"516","MJ Henry ","New Zealand",2014,2019,52,50,17,17,17,0,0,2
"517","Khaled Mahmud ","Bangladesh",1998,2006,77,77,17,17,17,0,0,2
"518","E Lewis ","West Indies",2016,2020,51,49,17,17,17,0,0,2
"519","EB McSweeney ","New Zealand",1986,1987,16,15,17,14,0,14,3,3
"520","PJ Ongondo (Afr/KENYA)",NA,1999,2011,79,79,17,17,17,0,0,2
"521","YK Pathan ","India",2008,2012,57,56,17,17,17,0,0,3
"522","RW Price ","Zimbabwe",2002,2012,102,102,17,17,17,0,0,2
"523","WB Rankin (ENG/IRE)",NA,2007,2020,75,73,17,17,17,0,0,2
"524","AT Rayudu ","India",2013,2019,55,53,17,17,17,0,0,2
"525","CJ Richards ","England",1981,1988,22,22,17,16,0,16,1,3
"526","TT Samaraweera ","Sri Lanka",1998,2011,53,51,17,17,17,0,0,2
"527","MS Sinclair ","New Zealand",2000,2009,54,54,17,17,15,2,0,2
"528","Umar Gul ","Pakistan",2003,2016,130,128,17,17,17,0,0,2
"529","GM Wood ","Australia",1978,1989,83,80,17,17,17,0,0,2
"530","Aamer Malik ","Pakistan",1988,1994,24,24,16,13,3,10,3,2
"531","CWJ Athey ","England",1980,1988,31,31,16,16,16,0,0,3
"532","JJ Atkinson ","Hong Kong",2008,2017,9,9,16,10,0,10,6,4
"533","WKM Benjamin ","West Indies",1986,1995,85,85,16,16,16,0,0,1
"534","N Chopra ","India",1998,2000,39,38,16,16,16,0,0,2
"535","KJ Coetzer ","Scotland",2008,2019,59,58,16,16,16,0,0,2
"536","PJ Cummins ","Australia",2011,2020,64,64,16,16,16,0,0,2
"537","Dawlat Zadran ","Afghanistan",2011,2019,82,80,16,16,16,0,0,2
"538","RL Dias ","Sri Lanka",1979,1987,58,58,16,16,16,0,0,2
"539","BN French ","England",1985,1988,13,13,16,13,0,13,3,3
"540","BJ Hodge ","Australia",2005,2007,25,25,16,16,16,0,0,2
"541","GP Howarth ","New Zealand",1975,1985,70,69,16,16,16,0,0,2
"542","APE Knott ","England",1971,1977,20,19,16,15,0,15,1,4
"543","T Mishra ","Kenya",2006,2013,42,42,16,16,16,0,0,2
"544","DA Murray ","West Indies",1973,1981,10,10,16,16,0,16,0,3
"545","TJ Murtagh ","Ireland",2012,2019,58,57,16,16,16,0,0,1
"546","Naved-ul-Hasan ","Pakistan",2003,2010,74,72,16,16,16,0,0,2
"547","A Ratra ","India",2002,2002,12,12,16,11,0,11,5,3
"548","GJ Rennie ","Zimbabwe",1996,2003,40,40,16,16,16,0,0,2
"549","RD Shah ","Kenya",1998,2007,56,56,16,16,16,0,0,2
"550","VS Solanki ","England",2000,2006,51,50,16,16,16,0,0,2
"551","A Vala ","Papau New Guinea",2014,2019,27,27,16,16,16,0,0,3
"552","Zaheer Abbas ","Pakistan",1974,1985,62,60,16,16,16,0,0,2
"553","Anil Dalpat ","Pakistan",1984,1986,15,14,15,13,0,13,2,3
"554","MA Atherton ","England",1990,1998,54,54,15,15,15,0,0,2
"555","Basit Ali ","Pakistan",1993,1996,50,49,15,15,15,0,0,2
"556","SE Bond ","New Zealand",2002,2010,82,80,15,15,15,0,0,2
"557","YS Chahal ","India",2016,2020,52,52,15,15,15,0,0,2
"558","SKL de Silva ","Sri Lanka",1997,1997,11,11,15,9,0,9,6,3
"559","PS de Villiers ","South Africa",1992,1997,83,82,15,15,15,0,0,2
"560","ST Finn ","England",2011,2017,69,67,15,15,15,0,0,2
"561","DT Hondo ","Zimbabwe",2001,2005,56,56,15,15,15,0,0,1
"562","VG Kambli ","India",1991,2000,104,101,15,15,15,0,0,1
"563","MD Marshall ","West Indies",1980,1992,136,134,15,15,15,0,0,2
"564","BAW Mendis ","Sri Lanka",2008,2015,87,85,15,15,15,0,0,2
"565","JA Morkel (Afr/SA)",NA,2004,2012,58,58,15,15,15,0,0,2
"566","Noor Ali Zadran ","Afghanistan",2009,2019,51,49,15,15,15,0,0,2
"567","AR Nurse ","West Indies",2016,2019,54,52,15,15,15,0,0,3
"568","AA Obanda ","Kenya",2007,2014,49,49,15,15,15,0,0,2
"569","JL Ontong (Afr/SA)",NA,2001,2012,28,27,15,15,15,0,0,2
"570","AR Patel ","India",2014,2017,38,36,15,15,15,0,0,2
"571","KL Rahul ","India",2016,2020,32,32,15,13,8,5,2,3
"572","Rizwan Cheema ","Canada",2008,2013,33,32,15,15,15,0,0,2
"573","Rohan Mustafa ","United Arab Emirates",2014,2020,37,37,15,15,15,0,0,2
"574","JD Ryder ","New Zealand",2008,2014,48,48,15,15,15,0,0,2
"575","Sohail Tanvir ","Pakistan",2007,2014,62,60,15,15,15,0,0,2
"576","CM Spearman ","New Zealand",1995,2001,51,51,15,15,15,0,0,1
"577","BC Strang ","Zimbabwe",1995,2001,49,48,15,15,15,0,0,2
"578","HA Varaiya ","Kenya",2006,2014,63,63,15,15,15,0,0,2
"579","KJ Wadsworth ","New Zealand",1973,1976,13,13,15,13,0,13,2,3
"580","CD Wallace ","Scotland",2012,2019,28,28,15,13,8,5,2,4
"581","Asad Shafiq ","Pakistan",2010,2017,60,59,14,14,14,0,0,2
"582","EAE Baptiste ","West Indies",1983,1990,43,43,14,14,14,0,0,2
"583","AC Cummins (CAN/WI)",NA,1991,2007,76,75,14,14,14,0,0,2
"584","A Dananjaya ","Sri Lanka",2012,2019,36,35,14,14,14,0,0,2
"585","C de Grandhomme ","New Zealand",2012,2020,42,42,14,14,14,0,0,2
"586","DW Fleming ","Australia",1994,2001,88,88,14,14,14,0,0,1
"587","HA Gomes ","West Indies",1978,1987,83,83,14,14,14,0,0,1
"588","PSP Handscomb ","Australia",2017,2019,22,22,14,14,9,5,0,3
"589","HMRKB Herath ","Sri Lanka",2004,2015,71,69,14,14,14,0,0,2
"590","Imran Farhat ","Pakistan",2001,2013,58,58,14,14,14,0,0,1
"591","HH Kanitkar ","India",1997,2000,34,34,14,14,14,0,0,2
"592","Mansoor Akhtar ","Pakistan",1980,1990,41,40,14,14,14,0,0,2
"593","LRD Mendis ","Sri Lanka",1975,1989,79,79,14,14,14,0,0,2
"594","AA Mulla ","Canada",2006,2009,24,24,14,9,5,4,5,2
"595","SP Narine ","West Indies",2011,2016,65,65,14,14,14,0,0,2
"596","KOA Powell ","West Indies",2009,2018,46,45,14,14,14,0,0,2
"597","R Powell ","West Indies",2016,2018,34,33,14,14,14,0,0,2
"598","R Rampaul ","West Indies",2003,2015,92,89,14,14,14,0,0,2
"599","JR Ratnayeke ","Sri Lanka",1982,1990,78,78,14,14,14,0,0,2
"600","Shafiqullah ","Afghanistan",2009,2018,24,24,14,11,3,8,3,2
"601","JC Tredwell ","England",2010,2015,45,44,14,14,14,0,0,2
"602","IJL Trott ","England",2009,2013,68,66,14,14,14,0,0,2
"603","LJ Tucker ","Ireland",2019,2020,8,8,14,13,1,12,1,3
"604","RR Watson ","Scotland",2006,2010,35,34,14,14,14,0,0,2
"605","Yasir Hameed ","Pakistan",2003,2007,56,56,14,14,14,0,0,2
"606","Aminul Islam ","Bangladesh",1988,2002,39,39,13,13,13,0,0,2
"607","HK Badani ","India",2000,2004,40,40,13,13,13,0,0,2
"608","B Bhandari ","Nepal",2019,2020,7,7,13,12,0,12,1,4
"609","SW Billings ","England",2015,2018,15,15,13,13,9,4,0,2
"610","PB Dassanayake ","Sri Lanka",1993,1994,16,16,13,9,0,9,4,2
"611","ALF de Mel ","Sri Lanka",1982,1987,57,57,13,13,13,0,0,2
"612","Dhiman Ghosh ","Bangladesh",2008,2008,14,14,13,9,0,9,4,4
"613","Farhad Reza ","Bangladesh",2006,2011,34,34,13,13,13,0,0,2
"614","DA Gunawardene ","Sri Lanka",1998,2006,61,61,13,13,13,0,0,2
"615","JR Hazlewood ","Australia",2010,2020,48,48,13,13,13,0,0,2
"616","RR Hendricks ","South Africa",2018,2020,21,20,13,13,13,0,0,3
"617","AJ Hollioake ","England",1996,1999,35,35,13,13,13,0,0,3
"618","MS Kasprowicz ","Australia",1995,2005,43,42,13,13,13,0,0,2
"619","SM Katich ","Australia",2001,2006,45,45,13,13,13,0,0,1
"620","UT Khawaja ","Australia",2013,2019,40,40,13,13,13,0,0,2
"621","NFI McCallum ","Scotland",2006,2011,43,42,13,13,13,0,0,2
"622","R McLaren ","South Africa",2009,2014,54,52,13,13,13,0,0,1
"623","Mehidy Hasan Miraz ","Bangladesh",2017,2020,41,40,13,13,13,0,0,3
"624","BMAJ Mendis ","Sri Lanka",2010,2019,58,56,13,13,13,0,0,2
"625","Mohsin Khan ","Pakistan",1977,1986,75,73,13,13,13,0,0,2
"626","Mosaddek Hossain ","Bangladesh",2016,2019,35,34,13,13,13,0,0,2
"627","Nasir Jamshed ","Pakistan",2008,2015,48,48,13,13,13,0,0,2
"628","HK Olonga ","Zimbabwe",1995,2003,50,50,13,13,13,0,0,2
"629","JS Patel ","New Zealand",2005,2017,43,42,13,13,13,0,0,1
"630","AL Phehlukwayo ","South Africa",2016,2020,58,56,13,13,13,0,0,2
"631","DBL Powell ","West Indies",2002,2009,55,55,13,13,13,0,0,2
"632","Shahriar Nafees ","Bangladesh",2005,2011,75,75,13,13,13,0,0,2
"633","Shoaib Mohammad ","Pakistan",1984,1993,63,62,13,13,13,0,0,2
"634","RP Singh ","India",2005,2011,58,58,13,13,13,0,0,1
"635","DS Smith ","West Indies",2003,2013,47,46,13,13,13,0,0,3
"636","RN ten Doeschate ","Netherlands",2006,2011,33,33,13,13,13,0,0,2
"637","GM Turner ","New Zealand",1973,1983,41,41,13,13,13,0,0,2
"638","DNT Zoysa ","Sri Lanka",1997,2007,95,94,13,13,13,0,0,2
"639","Akshay Homraj ","United States of America",2019,2020,8,8,12,12,0,12,0,4
"640","Amjad Ali ","United Arab Emirates",2008,2015,17,17,12,11,7,4,1,3
"641","PK Amre ","India",1991,1994,37,36,12,12,12,0,0,2
"642","RMH Binny ","India",1980,1987,72,70,12,12,12,0,0,2
"643","IR Bishop ","West Indies",1988,1997,84,83,12,12,12,0,0,1
"644","DE Bollinger ","Australia",2009,2011,39,39,12,12,12,0,0,1
"645","JM Brearley ","England",1977,1980,25,25,12,12,12,0,0,2
"646","C Carter ","Hong Kong",2015,2018,11,11,12,10,1,9,2,3
"647","CD Collymore ","West Indies",1999,2007,84,83,12,12,12,0,0,2
"648","TLW Cooper ","Netherlands",2010,2013,23,23,12,12,12,0,0,2
"649","KM Dabengwa ","Zimbabwe",2005,2010,37,37,12,12,12,0,0,2
"650","JWM Dalrymple ","England",2006,2007,27,27,12,12,12,0,0,2
"651","KSC de Silva ","Sri Lanka",1996,2000,38,37,12,12,12,0,0,2
"652","J Dyson ","Australia",1980,1983,29,29,12,12,12,0,0,3
"653","BA Edgar ","New Zealand",1978,1986,64,63,12,12,12,0,0,2
"654","CN Evans ","Zimbabwe",1992,2002,53,52,12,12,12,0,0,2
"655","NA Foster ","England",1984,1989,48,48,12,12,12,0,0,2
"656","Gulbadin Naib ","Afghanistan",2011,2019,65,63,12,12,12,0,0,1
"657","MD Gunathilaka ","Sri Lanka",2015,2019,38,37,12,12,12,0,0,2
"658","Hasan Ali ","Pakistan",2016,2019,53,52,12,12,12,0,0,2
"659","TM Head ","Australia",2016,2018,42,42,12,12,12,0,0,2
"660","MJ Horne ","New Zealand",1997,2002,50,49,12,12,12,0,0,2
"661","Imad Wasim ","Pakistan",2015,2019,53,52,12,12,12,0,0,1
"662","CA Ingram ","South Africa",2010,2013,31,31,12,12,12,0,0,2
"663","Javed Omar ","Bangladesh",1995,2007,59,59,12,12,12,0,0,2
"664","SG Law ","Australia",1994,1999,54,54,12,12,12,0,0,2
"665","DA Marillier ","Zimbabwe",2000,2003,48,48,12,12,12,0,0,2
"666","AK Markram ","South Africa",2017,2019,26,25,12,12,12,0,0,3
"667","XM Marshall (USA/WI)",NA,2005,2020,37,36,12,12,12,0,0,2
"668","T Maruma ","Zimbabwe",2007,2019,21,21,12,12,12,0,0,3
"669","SF Mire ","Zimbabwe",2014,2019,47,47,12,12,12,0,0,1
"670","HS Modi ","Kenya",1996,2006,63,63,12,12,12,0,0,2
"671","J Mubarak ","Sri Lanka",2002,2013,40,40,12,12,12,0,0,2
"672","Mustafizur Rahman ","Bangladesh",2015,2020,58,57,12,12,12,0,0,2
"673","Nadeem Ahmed ","Hong Kong",2004,2018,25,25,12,12,12,0,0,2
"674","MO Odumbe ","Kenya",1996,2003,61,61,12,12,12,0,0,2
"675","JM Parker ","New Zealand",1974,1981,24,24,12,11,11,0,1,3
"676","WD Parnell ","South Africa",2009,2017,65,62,12,12,12,0,0,2
"677","DA Reeve ","England",1991,1996,29,29,12,12,12,0,0,3
"678","JA Rennie ","Zimbabwe",1993,2000,44,44,12,12,12,0,0,2
"679","PM Seelaar ","Netherlands",2006,2019,41,41,12,12,12,0,0,2
"680","Shaiman Anwar ","United Arab Emirates",2014,2019,40,40,12,12,12,0,0,2
"681","MP Stoinis ","Australia",2015,2019,41,41,12,12,12,0,0,1
"682","C White ","England",1994,2003,51,50,12,12,12,0,0,1
"683","CJ Anderson ","New Zealand",2013,2017,49,48,11,11,11,0,0,2
"684","Babar Hayat ","Hong Kong",2014,2018,22,22,11,11,11,0,0,2
"685","L Balaji ","India",2002,2009,30,30,11,11,11,0,0,2
"686","AM Blignaut ","Zimbabwe",1999,2010,54,54,11,11,11,0,0,2
"687","AC Botha ","Ireland",2006,2011,42,40,11,11,11,0,0,2
"688","EA Brandes ","Zimbabwe",1987,1999,59,59,11,11,11,0,0,1
"689","CR Brathwaite ","West Indies",2011,2019,44,42,11,11,11,0,0,1
"690","RL Chase ","West Indies",2017,2020,30,28,11,11,11,0,0,2
"691","R Clarke ","England",2003,2006,20,20,11,11,11,0,0,3
"692","RDB Croft ","England",1996,2001,50,49,11,11,11,0,0,1
"693","AC Dale ","Australia",1997,2000,30,30,11,11,11,0,0,1
"694","J Edness ","Bermuda",2007,2008,11,11,11,7,0,7,4,3
"695","D Ganga ","West Indies",1999,2006,35,35,11,11,11,0,0,2
"696","DW Hookes ","Australia",1977,1986,39,37,11,11,11,0,0,2
"697","KM Jarvis ","Zimbabwe",2009,2019,49,49,11,11,11,0,0,2
"698","Javed Ahmadi ","Afghanistan",2010,2019,44,41,11,11,11,0,0,1
"699","PN Kirsten ","South Africa",1991,1994,40,40,11,11,11,0,0,2
"700","P Kumar ","India",2007,2012,68,67,11,11,11,0,0,2
"701","CK Langeveldt ","South Africa",2001,2010,72,71,11,11,11,0,0,1
"702","RT Latham ","New Zealand",1990,1994,33,33,11,11,11,0,0,2
"703","Mohammad Irfan ","Pakistan",2010,2016,60,60,11,11,11,0,0,2
"704","CB Mpofu ","Zimbabwe",2004,2020,84,83,11,11,11,0,0,1
"705","HG Munsey ","Scotland",2017,2019,25,25,11,11,11,0,0,2
"706","BA Murphy ","Zimbabwe",2000,2003,31,31,11,11,11,0,0,2
"707","D Murphy ","Scotland",2013,2013,8,8,11,8,0,8,3,5
"708","TK Musakanda ","Zimbabwe",2016,2018,15,15,11,11,11,0,0,2
"709","P Mustard ","England",2007,2008,10,10,11,9,0,9,2,2
"710","F Mutizwa ","Zimbabwe",2009,2011,17,17,11,9,1,8,2,3
"711","RJ Nicol ","New Zealand",2011,2013,22,22,11,11,11,0,0,2
"712","SB O'Connor ","New Zealand",1997,2000,38,38,11,11,11,0,0,2
"713","H Osinde ","Canada",2006,2013,42,41,11,11,11,0,0,2
"714","MM Patel ","India",2006,2011,70,68,11,11,11,0,0,2
"715","SM Patil ","India",1980,1986,45,44,11,11,11,0,0,2
"716","SP Patil ","United Arab Emirates",2014,2015,13,13,11,8,0,8,3,3
"717","DR Pringle ","England",1982,1993,44,44,11,11,11,0,0,2
"718","CPH Ramanayake ","Sri Lanka",1986,1995,62,62,11,11,11,0,0,2
"719","RJ Ratnayake ","Sri Lanka",1982,1993,70,70,11,11,11,0,0,2
"720","SJ Rhodes ","England",1989,1995,9,9,11,9,0,9,2,4
"721","SJ Rixon ","Australia",1978,1985,6,6,11,9,0,9,2,4
"722","JA Rudolph (Afr/SA)",NA,2003,2006,45,45,11,11,11,0,0,2
"723","AD Russell ","West Indies",2011,2019,56,56,11,11,11,0,0,1
"724","Sanwar Hossain ","Bangladesh",1998,2003,27,27,11,11,11,0,0,2
"725","SM Sharif ","Scotland",2011,2019,44,44,11,11,11,0,0,2
"726","MA Suji ","Kenya",1996,2006,64,64,11,11,11,0,0,2
"727","Tahir Naqqash ","Pakistan",1980,1985,40,38,11,11,11,0,0,2
"728","TP Ura ","Papau New Guinea",2014,2019,26,26,11,11,11,0,0,2
"729","DLS van Bunge ","Netherlands",2002,2013,37,37,11,11,11,0,0,2
"730","MN van Wyk ","South Africa",2003,2015,17,17,11,10,1,9,1,4
"731","PA Wallace ","West Indies",1991,2000,33,32,11,11,11,0,0,2
"732","MR Whitney ","Australia",1983,1993,38,38,11,11,11,0,0,3
"733","MA Wood ","England",2015,2019,51,50,11,11,11,0,0,2
"734","A Zampa ","Australia",2016,2020,55,55,11,11,11,0,0,1
"735","Amir Hamza ","Afghanistan",2012,2017,31,31,10,10,10,0,0,2
"736","Anamul Haque ","Bangladesh",2012,2019,38,38,10,10,4,6,0,3
"737","SD Anurasiri ","Sri Lanka",1986,1994,45,45,10,10,10,0,0,2
"738","Arshad Khan ","Pakistan",1993,2006,58,57,10,10,10,0,0,2
"739","SFAF Bacchus ","West Indies",1978,1983,29,29,10,10,10,0,0,2
"740","BC Broad ","England",1987,1988,34,34,10,10,10,0,0,1
"741","RK Chauhan ","India",1993,1997,35,34,10,10,10,0,0,1
"742","DT Christian ","Australia",2012,2014,19,19,10,10,10,0,0,2
"743","SR Clark ","Australia",2005,2009,39,39,10,10,10,0,0,2
"744","JH Davey ","Scotland",2010,2019,31,30,10,10,10,0,0,2
"745","SB Doull ","New Zealand",1992,2000,42,42,10,10,10,0,0,2
"746","Fawad Alam ","Pakistan",2007,2015,38,38,10,10,10,0,0,2
"747","LH Ferguson ","New Zealand",2016,2020,37,37,10,10,10,0,0,1
"748","JN Gillespie ","Australia",1996,2005,97,97,10,10,10,0,0,1
"749","DAS Gunaratne ","Sri Lanka",2016,2019,31,30,10,10,10,0,0,2
"750","RM Haq ","Scotland",2006,2015,54,52,10,10,10,0,0,2
"751","SJ Harmison ","England",2002,2009,58,58,10,10,10,0,0,1
"752","BW Hilfenhaus ","Australia",2007,2012,25,25,10,10,10,0,0,2
"753","TG Hogan ","Australia",1983,1984,16,15,10,10,10,0,0,2
"754","Iftikhar Anjum ","Pakistan",2004,2010,62,61,10,10,10,0,0,3
"755","Ihsanullah ","Afghanistan",2017,2018,16,16,10,10,10,0,0,3
"756","LM Jongwe ","Zimbabwe",2014,2016,22,22,10,10,10,0,0,3
"757","M Kartik ","India",2002,2007,37,37,10,10,10,0,0,1
"758","FDM Karunaratne ","Sri Lanka",2011,2020,31,31,10,10,10,0,0,1
"759","R Lamba ","India",1986,1989,32,32,10,10,10,0,0,1
"760","RDM Leverock ","Bermuda",2006,2009,32,32,10,10,10,0,0,2
"761","DK Lillee ","Australia",1972,1983,63,63,10,10,10,0,0,2
"762","DR Lockhart ","Scotland",2006,2010,14,14,10,10,1,9,0,3
"763","CR Matthews ","South Africa",1991,1997,56,55,10,10,10,0,0,2
"764","BJ McCarthy ","Ireland",2016,2020,30,30,10,10,10,0,0,2
"765","Mohammad Salman ","Pakistan",2011,2011,7,7,10,8,0,8,2,4
"766","DS Mohanty ","India",1997,2001,45,44,10,10,10,0,0,2
"767","Muhammad Usman ","United Arab Emirates",2016,2020,33,33,10,10,10,0,0,3
"768","KMA Paul ","West Indies",2018,2020,19,19,10,10,10,0,0,2
"769","Saleem Elahi ","Pakistan",1995,2004,48,47,10,10,10,0,0,2
"770","Shabbir Ahmed ","Pakistan",1999,2005,32,32,10,10,10,0,0,2
"771","Simi Singh ","Ireland",2017,2020,18,18,10,10,10,0,0,2
"772","Tauseef Ahmed ","Pakistan",1982,1990,70,68,10,10,10,0,0,1
"773","KL Tucker ","Bermuda",2006,2007,12,12,10,9,1,8,1,4
"774","AC Waller ","Zimbabwe",1987,1997,39,38,10,10,10,0,0,2
"775","KD Walters ","Australia",1971,1981,28,28,10,10,10,0,0,3
"776","CAK Walton ","West Indies",2009,2017,9,9,10,9,3,6,1,4
"777","MH Yardy ","England",2006,2011,28,28,10,10,10,0,0,2
"778","Yashpal Sharma ","India",1978,1985,42,42,10,10,10,0,0,1
"779","CJA Amini ","Papau New Guinea",2014,2019,15,15,9,9,9,0,0,1
"780","HS Baidwan ","Canada",2008,2014,32,32,9,9,9,0,0,1
"781","HMCM Bandara ","Sri Lanka",2006,2010,31,30,9,9,9,0,0,3
"782","SJ Benn ","West Indies",2008,2016,47,46,9,9,9,0,0,1
"783","NT Broom ","New Zealand",2009,2017,39,39,9,9,9,0,0,2
"784","AR Caddick ","England",1993,2003,54,53,9,9,9,0,0,2
"785","LOB Cann ","Bermuda",2006,2009,26,26,9,9,9,0,0,2
"786","PP Chawla ","India",2007,2011,25,25,9,9,9,0,0,3
"787","N Deonarine ","West Indies",2005,2015,31,31,9,9,9,0,0,2
"788","SI de Saram ","Sri Lanka",1999,2001,15,15,9,9,9,0,0,2
"789","MA Ealham ","England",1996,2001,64,63,9,9,9,0,0,1
"790","S Elworthy ","South Africa",1998,2002,39,38,9,9,9,0,0,3
"791","ZE Green ","Namibia",2019,2020,8,8,9,7,0,7,2,5
"792","Hashmatullah Shahidi ","Afghanistan",2013,2019,39,38,9,9,9,0,0,1
"793","AS Joseph ","West Indies",2016,2020,28,27,9,9,9,0,0,2
"794","IA Karim ","Kenya",2011,2014,9,9,9,8,3,5,1,2
"795","CM Kuggeleijn ","New Zealand",1988,1989,16,16,9,9,9,0,0,2
"796","NC McGarrell ","West Indies",1998,2001,17,17,9,9,9,0,0,2
"797","RD McCann ","Ireland",2010,2010,8,8,9,9,0,9,0,3
"798","SS McKechnie ","Hong Kong",2017,2018,8,8,9,8,1,7,1,4
"799","Mohammad Wasim ","Pakistan",1996,2000,25,25,9,9,9,0,0,2
"800","CH Morris ","South Africa",2013,2019,42,40,9,9,9,0,0,1
"801","T Mupariwa ","Zimbabwe",2004,2016,40,40,9,9,9,0,0,1
"802","Nizakat Khan ","Hong Kong",2014,2018,20,20,9,9,9,0,0,2
"803","SJ Palframan ","South Africa",1996,1996,7,7,9,9,0,9,0,3
"804","RR Pant ","India",2018,2020,16,16,9,8,4,4,1,2
"805","T Panyangara ","Zimbabwe",2004,2016,65,65,9,9,9,0,0,2
"806","BP Patterson ","West Indies",1986,1993,59,58,9,9,9,0,0,1
"807","N Pooran ","West Indies",2019,2020,25,24,9,8,7,1,1,2
"808","AD Poynter ","Ireland",2008,2014,19,18,9,9,9,0,0,2
"809","Rajin Saleh ","Bangladesh",2003,2006,43,43,9,9,9,0,0,2
"810","GM Ritchie ","Australia",1982,1987,44,44,9,9,9,0,0,2
"811","AM Samad ","Canada",2003,2009,27,26,9,9,9,0,0,2
"812","MJ Slater ","Australia",1993,1997,42,42,9,9,9,0,0,2
"813","RS Sodhi ","India",2000,2002,18,18,9,9,9,0,0,2
"814","Sohaib Maqsood ","Pakistan",2013,2016,26,26,9,9,9,0,0,2
"815","Sohrawordi Shuvo ","Bangladesh",2010,2011,17,17,9,9,9,0,0,2
"816","Suraj Kumar ","Oman",2019,2020,11,11,9,9,0,9,0,2
"817","Taufeeq Umar ","Pakistan",2001,2011,22,22,9,9,9,0,0,1
"818","JR Thomson ","Australia",1975,1985,50,50,9,9,9,0,0,2
"819","LL Tsotsobe ","South Africa",2009,2013,61,60,9,9,9,0,0,2
"820","JJ Tucker ","Bermuda",2006,2009,26,26,9,9,9,0,0,2
"821","HE van der Dussen ","South Africa",2019,2020,21,19,9,9,9,0,0,2
"822","JNT Vare ","Papau New Guinea",2014,2018,9,9,9,6,0,6,3,3
"823","M Vijay ","India",2010,2015,17,17,9,9,9,0,0,2
"824","W Watson ","New Zealand",1986,1994,61,61,9,9,9,0,0,1
"825","AR Adams ","New Zealand",2001,2007,42,41,8,8,8,0,0,2
"826","Akram Khan ","Bangladesh",1988,2003,44,44,8,8,8,0,0,2
"827","Amjad Javed ","United Arab Emirates",2008,2017,15,15,8,8,8,0,0,1
"828","Azhar Ali ","Pakistan",2011,2018,53,52,8,8,8,0,0,1
"829","GS Ballance ","England",2013,2015,16,16,8,8,8,0,0,2
"830","D Bau ","Papau New Guinea",2016,2017,10,10,8,6,1,5,2,3
"831","S Bau ","Papau New Guinea",2016,2019,21,21,8,8,8,0,0,1
"832","ID Blackwell ","England",2002,2006,34,34,8,8,8,0,0,2
"833","JAR Blain ","Scotland",1999,2009,33,32,8,8,8,0,0,1
"834","MG Burgess ","New Zealand",1973,1981,26,26,8,8,8,0,0,2
"835","RP Burl ","Zimbabwe",2017,2019,18,18,8,8,8,0,0,2
"836","IG Butler ","New Zealand",2002,2010,26,25,8,8,8,0,0,2
"837","TM Chappell ","Australia",1980,1983,20,20,8,8,8,0,0,2
"838","FRJ Coleman ","Scotland",2013,2015,16,15,8,8,8,0,0,3
"839","PT Collins ","West Indies",1999,2005,30,30,8,8,8,0,0,2
"840","MD Dai ","Papau New Guinea",2014,2018,18,18,8,8,8,0,0,2
"841","SM Davies ","England",2009,2011,8,8,8,8,0,8,0,2
"842","S Dhaniram ","Canada",2006,2010,44,43,8,8,8,0,0,1
"843","Enamul Haque jnr ","Bangladesh",2005,2009,10,10,8,8,8,0,0,2
"844","AC Evans ","Scotland",2009,2019,36,35,8,8,8,0,0,1
"845","ADS Fletcher ","West Indies",2008,2016,25,25,8,5,3,2,3,3
"846","Hannan Sarkar ","Bangladesh",2002,2004,20,20,8,8,6,2,0,2
"847","RM Hogg ","Australia",1979,1985,71,69,8,8,8,0,0,1
"848","RIC Holder ","West Indies",1993,1997,37,37,8,8,8,0,0,3
"849","RK Illingworth ","England",1991,1996,25,25,8,8,8,0,0,2
"850","SS Iyer ","India",2017,2020,18,18,8,8,8,0,0,2
"851","BP Julian ","Australia",1993,1999,25,25,8,8,8,0,0,2
"852","Junaid Khan ","Pakistan",2011,2019,76,76,8,8,8,0,0,1
"853","AI Kallicharran ","West Indies",1973,1981,31,31,8,8,8,0,0,2
"854","SC Khanna ","India",1979,1984,10,9,8,4,0,4,4,3
"855","GF Labrooy ","Sri Lanka",1986,1992,44,44,8,8,8,0,0,1
"856","W Larkins ","England",1979,1991,25,25,8,8,8,0,0,1
"857","NAM McLean ","West Indies",1996,2003,45,45,8,8,8,0,0,2
"858","Manjural Islam ","Bangladesh",1999,2003,34,34,8,8,8,0,0,1
"859","VJ Marks ","England",1980,1988,34,34,8,8,8,0,0,1
"860","Mirwais Ashraf ","Afghanistan",2009,2016,46,45,8,8,8,0,0,2
"861","Mohammad Akram ","Pakistan",1995,2000,23,21,8,8,8,0,0,2
"862","Mohammad Amir ","Pakistan",2009,2019,61,60,8,8,8,0,0,2
"863","S Mukuddem ","Bermuda",2006,2007,20,20,8,8,8,0,0,1
"864","AD Mullally ","England",1996,2001,50,49,8,8,8,0,0,2
"865","L Ngidi ","South Africa",2018,2020,26,26,8,8,8,0,0,2
"866","CM Old ","England",1973,1981,32,32,8,8,8,0,0,2
"867","DR Parry ","West Indies",1978,1980,6,6,8,8,8,0,0,2
"868","KR Pushpakumara ","Sri Lanka",1994,1999,31,31,8,8,8,0,0,3
"869","EC Rainsford ","Zimbabwe",2004,2010,39,39,8,8,8,0,0,2
"870","SLV Raju ","India",1990,1996,53,52,8,8,8,0,0,1
"871","MR Ramprakash ","England",1991,2001,18,18,8,8,8,0,0,2
"872","MJR Rindel ","South Africa",1994,1999,22,22,8,8,8,0,0,2
"873","IH Romaine ","Bermuda",2006,2009,35,35,8,8,8,0,0,2
"874","PADLR Sandakan ","Sri Lanka",2016,2020,24,24,8,8,8,0,0,2
"875","Sarfraz Nawaz ","Pakistan",1973,1984,45,45,8,8,8,0,0,1
"876","TL Seifert ","New Zealand",2019,2019,3,3,8,7,0,7,1,4
"877","Shadab Khan ","Pakistan",2017,2019,43,43,8,8,8,0,0,1
"878","Shafiul Islam ","Bangladesh",2010,2020,60,60,8,8,8,0,0,2
"879","L Siaka ","Papau New Guinea",2014,2019,25,25,8,8,8,0,0,2
"880","SB Smith ","Australia",1983,1985,28,27,8,8,8,0,0,1
"881","IS Sodhi ","New Zealand",2015,2020,33,32,8,8,8,0,0,2
"882","Syed Rasel ","Bangladesh",2005,2010,52,52,8,8,8,0,0,2
"883","SW Tait ","Australia",2007,2011,35,35,8,8,8,0,0,2
"884","Tapash Baisya ","Bangladesh",2002,2007,56,56,8,8,8,0,0,1
"885","SR Taylor ","United States of America",2019,2020,12,12,8,8,8,0,0,2
"886","SR Thompson ","Ireland",2013,2017,20,19,8,8,8,0,0,1
"887","N Vanua ","Papau New Guinea",2014,2019,23,23,8,8,8,0,0,2
"888","MRJ Veletta ","Australia",1987,1989,20,20,8,8,7,1,0,3
"889","DM Wellham ","Australia",1981,1987,17,17,8,8,8,0,0,2
"890","LR Williams ","West Indies",1996,2001,15,15,8,8,8,0,0,2
"891","KJ Wright ","Australia",1979,1979,5,5,8,8,0,8,0,2
"892","KJ Abbott ","South Africa",2013,2016,28,27,7,7,7,0,0,2
"893","Abdur Rehman ","Pakistan",2006,2014,31,31,7,7,7,0,0,2
"894","PR Adams ","South Africa",1996,2003,24,24,7,7,7,0,0,2
"895","Al Sahariar ","Bangladesh",1999,2003,29,29,7,7,7,0,0,2
"896","Asif Iqbal ","Pakistan",1973,1979,10,10,7,7,7,0,0,2
"897","KBJ Azad ","India",1980,1986,25,24,7,7,7,0,0,2
"898","GEF Barnett ","Canada",2006,2010,22,22,7,7,7,0,0,1
"899","DE Bernard ","West Indies",2003,2010,20,19,7,7,7,0,0,1
"900","IS Billcliff ","Canada",2003,2009,19,19,7,7,7,0,0,2
"901","D Bishoo ","West Indies",2011,2019,42,41,7,7,7,0,0,1
"902","GS Blewett ","Australia",1995,1999,32,32,7,7,7,0,0,2
"903","JL Carter ","West Indies",2015,2019,33,32,7,7,7,0,0,2
"904","NM Coulter-Nile ","Australia",2013,2019,32,32,7,7,7,0,0,1
"905","CD de Lange ","Scotland",2016,2017,13,13,7,7,7,0,0,3
"906","TBM de Leede ","Netherlands",1996,2007,29,29,7,7,7,0,0,2
"907","JL Denly ","England",2009,2020,16,16,7,7,7,0,0,2
"908","AIC Dodemaide ","Australia",1988,1993,24,24,7,7,7,0,0,2
"909","MG Erasmus ","Namibia",2019,2020,8,8,7,7,7,0,0,2
"910","CJ Ferguson ","Australia",2009,2011,30,29,7,7,7,0,0,2
"911","SR Gillespie ","New Zealand",1986,1988,19,19,7,7,7,0,0,2
"912","G Goudie ","Scotland",2008,2013,16,16,7,7,7,0,0,2
"913","AW Greig ","England",1972,1977,22,21,7,7,7,0,0,3
"914","R Gunasekera ","Canada",2008,2014,19,19,7,7,7,0,0,2
"915","GM Hamilton ","Scotland",1999,2010,38,38,7,6,6,0,1,1
"916","AS Hansra ","Canada",2010,2014,24,24,7,7,7,0,0,1
"917","MN Hart ","New Zealand",1994,2002,13,13,7,7,7,0,0,2
"918","DL Hemp ","Bermuda",2006,2009,22,22,7,7,7,0,0,3
"919","AG Huckle ","Zimbabwe",1997,1999,19,19,7,7,7,0,0,2
"920","Humayun Farhat ","Pakistan",2001,2001,5,5,7,4,0,4,3,3
"921","KAD Hurdle ","Bermuda",2006,2007,19,19,7,7,7,0,0,1
"922","Imam-ul-Haq ","Pakistan",2017,2019,37,36,7,7,7,0,0,1
"923","Jahurul Islam ","Bangladesh",2010,2013,14,14,7,7,3,4,0,3
"924","NG Jones ","Ireland",2010,2011,14,14,7,7,7,0,0,2
"925","S Randiv ","Sri Lanka",2009,2016,31,30,7,7,7,0,0,1
"926","SHT Kandamby ","Sri Lanka",2004,2014,39,38,7,7,7,0,0,2
"927","P Khadka ","Nepal",2018,2020,10,10,7,7,7,0,0,3
"928","Khawar Ali ","Oman",2019,2020,11,11,7,7,7,0,0,2
"929","Kuldeep Yadav ","India",2017,2020,60,59,7,7,7,0,0,1
"930","NR Kumar ","Canada",2010,2014,16,16,7,7,7,0,0,2
"931","RN Lewis ","West Indies",1997,2009,28,28,7,7,7,0,0,1
"932","NM Lyon ","Australia",2012,2019,29,29,7,7,7,0,0,2
"933","PD McGlashan ","New Zealand",2009,2009,4,4,7,7,0,7,0,3
"934","CJ McKay ","Australia",2009,2014,59,59,7,7,7,0,0,3
"935","CS Martin ","New Zealand",2001,2008,20,19,7,7,7,0,0,1
"936","SW Masakadza ","Zimbabwe",2010,2014,16,16,7,7,7,0,0,3
"937","Mehrab Hossain jnr ","Bangladesh",2006,2009,18,18,7,7,7,0,0,1
"938","Mohammad Mithun ","Bangladesh",2014,2020,27,27,7,7,7,0,0,2
"939","VV Morea ","Papau New Guinea",2014,2018,13,13,7,7,7,0,0,2
"940","CT Mutombodzi ","Zimbabwe",2013,2020,14,14,7,7,7,0,0,3
"941","B Muzarabani ","Zimbabwe",2018,2018,18,18,7,7,7,0,0,2
"942","Naimur Rahman ","Bangladesh",1995,2002,29,29,7,7,7,0,0,2
"943","J Nyumbu ","Zimbabwe",2014,2015,19,19,7,7,7,0,0,2
"944","NN Odhiambo ","Kenya",2006,2014,69,69,7,7,7,0,0,1
"945","PP Ojha ","India",2008,2012,18,18,7,7,7,0,0,3
"946","E Otieno ","Kenya",2007,2014,26,26,7,7,7,0,0,2
"947","MK Pandey ","India",2015,2020,26,26,7,7,7,0,0,1
"948","BJ Patel ","Kenya",2001,2006,31,31,7,7,7,0,0,1
"949","H Patel ","Canada",2009,2013,23,22,7,7,7,0,0,2
"950","SR Patel ","England",2008,2013,36,36,7,7,7,0,0,2
"951","NS Poonia ","Scotland",2006,2009,21,20,7,7,7,0,0,2
"952","S Prasanna ","Sri Lanka",2011,2019,40,40,7,7,7,0,0,1
"953","C Pringle ","New Zealand",1990,1995,64,64,7,7,7,0,0,1
"954","SMA Priyanjan ","Sri Lanka",2013,2015,23,23,7,7,7,0,0,1
"955","DJ Reekers ","Netherlands",2006,2009,19,19,7,7,7,0,0,2
"956","KW Richardson ","Australia",2013,2020,25,25,7,7,7,0,0,2
"957","BG Rogers ","Zimbabwe",2002,2005,15,15,7,7,7,0,0,1
"958","V Shankar ","India",2019,2019,12,12,7,7,7,0,0,1
"959","C Sharma ","India",1983,1994,65,64,7,7,7,0,0,1
"960","SK Sharma ","India",1988,1990,23,23,7,7,7,0,0,2
"961","M Sheikh ","Kenya",1997,2000,21,21,7,7,7,0,0,1
"962","L Sivaramakrishnan ","India",1985,1987,16,16,7,7,7,0,0,3
"963","GC Small ","England",1987,1992,53,53,7,7,7,0,0,2
"964","RP Snell ","South Africa",1991,1996,42,42,7,7,7,0,0,1
"965","Sohag Gazi ","Bangladesh",2012,2014,20,20,7,7,7,0,0,2
"966","TB Sole ","Scotland",2018,2019,10,10,7,7,7,0,0,2
"967","S Sreesanth ","India",2005,2011,53,52,7,7,7,0,0,1
"968","WF Stelling ","Netherlands",2006,2007,15,15,7,7,7,0,0,1
"969","ES Szwarczynski ","Netherlands",2006,2014,41,41,7,7,7,0,0,1
"970","Taskin Ahmed ","Bangladesh",2014,2017,32,31,7,7,7,0,0,1
"971","CJ Tavare ","England",1980,1984,29,29,7,7,7,0,0,2
"972","JWA Taylor ","England",2011,2015,27,27,7,7,7,0,0,3
"973","AC Voges ","Australia",2007,2013,31,31,7,7,7,0,0,2
"974","DF Watts ","Scotland",2006,2011,36,35,7,7,7,0,0,2
"975","VJ Wells ","England",1999,1999,9,9,7,7,7,0,0,3
"976","Aftab Alam ","Afghanistan",2010,2019,27,27,6,6,6,0,0,2
"977","AC Agar ","Australia",2015,2020,13,13,6,6,6,0,0,1
"978","FA Allen ","West Indies",2018,2020,14,13,6,6,6,0,0,2
"979","Ashfaq Ahmed ","United Arab Emirates",2018,2019,16,16,6,6,6,0,0,2
"980","IDR Bradshaw ","West Indies",2004,2007,62,62,6,6,6,0,0,1
"981","JP Bray ","Ireland",2006,2007,15,15,6,6,5,1,0,2
"982","AD Brown ","England",1996,2001,16,16,6,6,6,0,0,2
"983","DG Brownlie ","New Zealand",2012,2017,16,16,6,6,6,0,0,1
"984","Mudassar Bukhari ","Netherlands",2007,2014,46,46,6,6,6,0,0,1
"985","LJ Burger ","Namibia",2003,2003,6,6,6,6,6,0,0,3
"986","DJ Callaghan ","South Africa",1992,2000,29,28,6,6,6,0,0,2
"987","DJ Capel ","England",1987,1990,23,23,6,6,6,0,0,2
"988","TL Chatara ","Zimbabwe",2013,2019,70,70,6,6,6,0,0,1
"989","S Chattergoon ","West Indies",2006,2009,18,17,6,6,6,0,0,2
"990","TS Chisoro ","Zimbabwe",2015,2018,18,17,6,6,6,0,0,2
"991","GR Codrington ","Canada",2006,2007,17,17,6,6,6,0,0,1
"992","DG Cork ","England",1992,2002,32,32,6,6,6,0,0,2
"993","CD Cumming ","New Zealand",2003,2009,13,13,6,6,6,0,0,2
"994","WM Darling ","Australia",1978,1982,18,17,6,6,6,0,0,3
"995","TN de Grooth ","Netherlands",2006,2013,34,34,6,6,6,0,0,1
"996","AM de Silva ","Sri Lanka",1986,1993,4,4,6,4,0,4,2,3
"997","EAR de Silva ","Sri Lanka",1986,1992,28,28,6,6,6,0,0,2
"998","T Duffin ","Zimbabwe",2006,2007,23,23,6,6,6,0,0,1
"999","PH Edmonds ","England",1977,1987,29,29,6,6,6,0,0,2
"1000","Enamul Haque ","Bangladesh",1990,2002,29,29,6,6,6,0,0,3
"1001","N Pradeep ","Sri Lanka",2012,2020,45,44,6,6,6,0,0,2
"1002","WIA Fernando ","Sri Lanka",2016,2020,18,18,6,6,6,0,0,2
"1003","G Fowler ","England",1983,1986,26,26,6,4,2,2,2,3
"1004","AD Gaekwad ","India",1975,1987,15,14,6,6,6,0,0,1
"1005","MR Gillespie ","New Zealand",2006,2009,32,31,6,6,6,0,0,2
"1006","Hamza Tariq ","Canada",2011,2014,7,7,6,5,0,5,1,2
"1007","RJ Harris ","Australia",2009,2012,21,21,6,6,6,0,0,1
"1008","Harvinder Singh ","India",1997,2001,16,16,6,6,6,0,0,1
"1009","Hasibul Hossain ","Bangladesh",1995,2004,32,32,6,6,6,0,0,2
"1010","UC Hathurusingha ","Sri Lanka",1992,1999,35,35,6,6,6,0,0,1
"1011","VA Holder ","West Indies",1973,1978,12,12,6,6,6,0,0,1
"1012","BC Hollioake ","England",1997,2002,20,20,6,6,6,0,0,1
"1013","MG Hughes ","Australia",1988,1993,33,33,6,6,6,0,0,1
"1014","Ikram Alikhil ","Afghanistan",2019,2019,12,11,6,3,0,3,3,2
"1015","Imtiaz Abbasi ","United Arab Emirates",1994,1996,7,7,6,4,0,4,2,2
"1016","RC Irani ","England",1996,2003,31,31,6,6,6,0,0,1
"1017","WR James ","Zimbabwe",1992,1996,11,11,6,6,3,3,0,2
"1018","TP Kamungozi ","Zimbabwe",2006,2015,14,14,6,6,6,0,0,2
"1019","AY Karim ","Kenya",1996,2003,34,34,6,6,6,0,0,1
"1020","Karim Sadiq ","Afghanistan",2009,2016,24,24,6,6,6,0,0,2
"1021","Khurram Khan ","United Arab Emirates",2004,2015,16,16,6,6,6,0,0,2
"1022","CL King ","West Indies",1976,1980,18,18,6,6,6,0,0,1
"1023","JK Lever ","England",1976,1982,22,22,6,6,6,0,0,2
"1024","DK Liyanage ","Sri Lanka",1992,2001,16,16,6,6,6,0,0,2
"1025","NB Mahwire ","Zimbabwe",2004,2006,23,23,6,6,6,0,0,2
"1026","Manjural Islam Rana ","Bangladesh",2003,2006,25,25,6,6,6,0,0,1
"1027","JJ Martin ","India",1999,2001,10,10,6,6,6,0,0,3
"1028","Mehrab Hossain ","Bangladesh",1998,2003,18,18,6,6,6,0,0,2
"1029","Mohammad Naveed ","United Arab Emirates",2014,2019,39,39,6,6,6,0,0,1
"1030","JFM Morrison ","New Zealand",1975,1983,18,18,6,6,6,0,0,2
"1031","Mujeeb Ur Rahman ","Afghanistan",2017,2019,40,39,6,6,6,0,0,1
"1032","Mushfiqur Rahman ","Bangladesh",2000,2004,28,28,6,6,6,0,0,1
"1033","MV Nagamootoo ","West Indies",2000,2002,24,24,6,6,6,0,0,1
"1034","A Nao ","Papau New Guinea",2017,2019,13,13,6,6,6,0,0,2
"1035","Nazmul Hossain ","Bangladesh",2004,2012,38,38,6,6,6,0,0,1
"1036","SN Netravalkar ","United States of America",2019,2020,13,13,6,6,6,0,0,3
"1037","JO Ngoche ","Kenya",2010,2013,17,17,6,6,6,0,0,1
"1038","ML Nkala ","Zimbabwe",1998,2006,50,50,6,6,6,0,0,1
"1039","AH Omarshah ","Zimbabwe",1983,1996,28,28,6,6,6,0,0,2
"1040","SD Outerbridge ","Bermuda",2006,2009,23,23,6,6,6,0,0,1
"1041","LS Pascoe ","Australia",1977,1982,29,29,6,6,6,0,0,1
"1042","TRO Payne ","West Indies",1984,1987,7,7,6,6,4,2,0,2
"1043","VD Philander ","South Africa",2007,2015,30,28,6,6,6,0,0,2
"1044","N Pokana ","Papau New Guinea",2017,2019,14,14,6,6,6,0,0,3
"1045","D Pretorius ","South Africa",2016,2019,22,22,6,6,6,0,0,2
"1046","AJ Pycroft ","Zimbabwe",1983,1992,20,20,6,6,6,0,0,2
"1047","CG Rackemann ","Australia",1983,1991,52,52,6,6,6,0,0,1
"1048","Rameez Shahzad ","United Arab Emirates",2016,2018,15,15,6,6,6,0,0,1
"1049","BA Reid ","Australia",1986,1992,61,61,6,6,6,0,0,2
"1050","AME Roberts ","West Indies",1975,1983,56,56,6,6,6,0,0,1
"1051","RT Robinson ","England",1984,1988,26,26,6,6,6,0,0,2
"1052","FA Rose ","West Indies",1997,2000,27,27,6,6,6,0,0,1
"1053","Sandeep Goud ","Oman",2019,2020,11,11,6,6,6,0,0,2
"1054","Shabir Noori ","Afghanistan",2010,2016,10,10,6,6,6,0,0,2
"1055","Sharjeel Khan ","Pakistan",2013,2017,25,25,6,6,6,0,0,1
"1056","AK Sharma ","India",1988,1993,31,31,6,6,6,0,0,2
"1057","MM Sharma ","India",2013,2015,26,25,6,6,6,0,0,1
"1058","RJ Sidebottom ","England",2001,2010,25,25,6,6,6,0,0,1
"1059","EO Simons ","South Africa",1994,1995,23,23,6,6,6,0,0,1
"1060","TAM Siriwardana ","Sri Lanka",2015,2019,27,26,6,6,6,0,0,2
"1061","ZE Surkari ","Canada",2008,2011,23,22,6,6,6,0,0,1
"1062","RML Taylor ","Scotland",2013,2016,15,15,6,6,6,0,0,2
"1063","Tushar Imran ","Bangladesh",2001,2007,41,41,6,6,6,0,0,1
"1064","Umar Amin ","Pakistan",2010,2018,16,16,6,6,6,0,0,2
"1065","DL Underwood ","England",1973,1982,26,26,6,6,6,0,0,2
"1066","AV Vadher ","Kenya",1997,1999,18,18,6,6,6,0,0,2
"1067","LP van Troost ","Netherlands",2002,2007,23,23,6,6,6,0,0,1
"1068","Y Venugopal Rao ","India",2005,2006,16,16,6,6,6,0,0,2
"1069","R Vinay Kumar ","India",2010,2013,31,31,6,6,6,0,0,2
"1070","MHN Walker ","Australia",1974,1981,17,17,6,6,6,0,0,1
"1071","MRJ Watt ","Scotland",2016,2019,27,27,6,6,6,0,0,1
"1072","AGD Wickremasinghe ","Sri Lanka",1992,1993,4,4,6,2,0,2,4,3
"1073","B Wood ","England",1972,1982,13,13,6,6,6,0,0,2
"1074","Yasir Shah ","Pakistan",2011,2019,25,25,6,6,6,0,0,2
"1075","Zeeshan Maqsood ","Oman",2019,2020,11,11,6,6,6,0,0,2
"1076","Abdul Shakoor ","United Arab Emirates",2015,2018,3,3,5,4,2,2,1,3
"1077","GI Allott ","New Zealand",1997,2000,31,31,5,5,5,0,0,1
"1078","Anshuman Rath ","Hong Kong",2014,2018,18,18,5,5,5,0,0,1
"1079","Arafat Sunny ","Bangladesh",2014,2015,16,16,5,5,5,0,0,1
"1080","V Aravind ","United Arab Emirates",2019,2020,6,6,5,4,0,4,1,3
"1081","Arshad Ayub ","India",1987,1990,32,32,5,5,5,0,0,1
"1082","Asif Ali ","Pakistan",2018,2019,18,17,5,5,5,0,0,1
"1083","JT Ball ","England",2016,2018,18,18,5,5,5,0,0,3
"1084","CA Best ","West Indies",1986,1992,24,23,5,5,5,0,0,2
"1085","U Bhatti ","Canada",2006,2010,36,35,5,5,5,0,0,1
"1086","SL Boock ","New Zealand",1978,1987,14,13,5,5,5,0,0,1
"1087","G Boycott ","England",1971,1981,36,35,5,5,5,0,0,3
"1088","DH Brain ","Zimbabwe",1992,1995,23,23,5,5,5,0,0,2
"1089","RD Brown ","Zimbabwe",1983,1987,7,7,5,5,5,0,0,2
"1090","RJ Campbell ","Australia",2002,2002,2,2,5,4,0,4,1,3
"1091","IM Chappell ","Australia",1971,1980,16,16,5,5,5,0,0,2
"1092","PKD Chase ","Ireland",2015,2018,25,24,5,5,5,0,0,2
"1093","NG Cowans ","England",1983,1985,23,23,5,5,5,0,0,1
"1094","CE Cuffy ","West Indies",1994,2002,41,41,5,5,5,0,0,1
"1095","WW Daniel ","West Indies",1978,1984,18,18,5,5,5,0,0,1
"1096","SP Davis ","Australia",1986,1988,39,39,5,5,5,0,0,1
"1097","MH Dekker ","Zimbabwe",1992,1996,23,23,5,5,5,0,0,1
"1098","JW Dernbach ","England",2011,2013,24,24,5,5,5,0,0,2
"1099","DS de Silva ","Sri Lanka",1975,1985,41,41,5,5,5,0,0,1
"1100","PWH de Silva ","Sri Lanka",2017,2020,15,15,5,5,5,0,0,2
"1101","K Doriga ","Papau New Guinea",2017,2019,14,14,5,4,1,3,1,1
"1102","VC Drakes ","West Indies",1995,2004,34,34,5,5,5,0,0,1
"1103","GD Drummond ","Scotland",2007,2013,30,29,5,5,5,0,0,1
"1104","H Durham ","Bermuda",2006,2006,9,9,5,5,5,0,0,2
"1105","GN Edwards ","New Zealand",1976,1981,6,6,5,5,3,2,0,2
"1106","RMS Eranga ","Sri Lanka",2011,2016,19,18,5,5,5,0,0,2
"1107","SM Ervine ","Zimbabwe",2001,2004,42,42,5,5,5,0,0,1
"1108","Faheem Ashraf ","Pakistan",2017,2019,23,22,5,5,5,0,0,1
"1109","SE Findlay ","West Indies",2008,2009,9,9,5,5,5,0,0,2
"1110","ARC Fraser ","England",1989,1999,42,42,5,5,5,0,0,1
"1111","RS Gavaskar ","India",2004,2004,11,11,5,5,5,0,0,2
"1112","AFG Griffith ","West Indies",1996,2000,9,9,5,5,5,0,0,2
"1113","Hamid Hassan ","Afghanistan",2009,2019,38,37,5,5,5,0,0,1
"1114","BR Hartland ","New Zealand",1992,1994,16,16,5,5,5,0,0,1
"1115","JW Hastings ","Australia",2010,2017,29,29,5,5,5,0,0,2
"1116","RC Haynes ","West Indies",1989,1991,8,8,5,5,5,0,0,2
"1117","EE Hemmings ","England",1982,1991,33,33,5,5,5,0,0,1
"1118","M Hendrick ","England",1973,1981,22,22,5,5,5,0,0,1
"1119","RS Higgins ","Zimbabwe",2006,2006,11,11,5,5,5,0,0,1
"1120","PJC Hoffmann ","Scotland",2006,2007,18,17,5,5,5,0,0,1
"1121","MJ Hoggard ","England",2001,2006,26,26,5,5,5,0,0,1
"1122","PJ Hughes ","Australia",2013,2014,25,25,5,5,3,2,0,2
"1123","RO Hurley ","West Indies",2003,2004,9,9,5,5,5,0,0,2
"1124","Imran Haider ","United Arab Emirates",2017,2019,20,20,5,5,5,0,0,1
"1125","Jatinder Singh ","Oman",2019,2020,11,11,5,5,5,0,0,1
"1126","WS Jayantha ","Sri Lanka",2004,2004,17,17,5,5,5,0,0,1
"1127","HAPW Jayawardene ","Sri Lanka",2003,2007,6,6,5,4,0,4,1,2
"1128","TE Jesty ","England",1983,1983,10,10,5,5,5,0,0,2
"1129","VB John ","Sri Lanka",1982,1987,45,45,5,5,5,0,0,1
"1130","MO Jones ","Bermuda",2006,2007,12,12,5,5,5,0,0,3
"1131","RJ Kirtley ","England",2001,2004,11,11,5,5,5,0,0,1
"1132","Krishna Chandran ","United Arab Emirates",2014,2016,12,12,5,5,5,0,0,2
"1133","BP Kruger ","Netherlands",2010,2011,5,5,5,5,5,0,0,3
"1134","BM Laird ","Australia",1979,1982,23,23,5,5,5,0,0,1
"1135","D Langford-Smith ","Ireland",2006,2008,22,21,5,5,5,0,0,2
"1136","KS Lokuarachchi ","Sri Lanka",2003,2007,21,21,5,5,5,0,0,1
"1137","GI Maiden ","Scotland",2010,2011,7,7,5,5,0,5,0,3
"1138","JS Malhotra ","United States of America",2019,2019,5,5,5,4,0,4,1,2
"1139","GA Manou ","Australia",2009,2009,4,4,5,5,0,5,0,3
"1140","A Mishra ","India",2003,2016,36,35,5,5,5,0,0,1
"1141","Mohammad Asif (Asia/PAK)",NA,2005,2010,38,36,5,5,5,0,0,2
"1142","Mohammad Hussain ","Pakistan",1997,1998,14,13,5,5,5,0,0,2
"1143","Mohammad Nawaz (3) ","Pakistan",2016,2019,15,15,5,5,5,0,0,2
"1144","Mohammad Tauqir ","United Arab Emirates",2004,2015,11,11,5,5,5,0,0,2
"1145","MD Moxon ","England",1985,1988,8,8,5,5,5,0,0,2
"1146","AN Petersen ","South Africa",2006,2013,21,21,5,5,5,0,0,1
"1147","N Pothas ","South Africa",2000,2000,3,3,5,4,0,4,1,3
"1148","Qaiser Ali ","Canada",2006,2008,17,17,5,5,5,0,0,2
"1149","JF Reid ","New Zealand",1980,1986,25,23,5,5,5,0,0,1
"1150","DM Richards ","West Indies",2009,2010,8,8,5,5,5,0,0,2
"1151","Sadiq Mohammad ","Pakistan",1973,1980,19,19,5,5,5,0,0,2
"1152","MAR Samarasekera ","Sri Lanka",1983,1994,39,39,5,5,5,0,0,2
"1153","BS Sandhu ","India",1982,1984,22,21,5,5,5,0,0,1
"1154","Shahadat Hossain ","Bangladesh",2006,2013,51,51,5,5,5,0,0,1
"1155","Shahriar Hossain ","Bangladesh",1997,2004,20,20,5,5,5,0,0,1
"1156","T Shamsi ","South Africa",2016,2020,22,21,5,5,5,0,0,2
"1157","Shapoor Zadran ","Afghanistan",2009,2019,44,44,5,5,5,0,0,1
"1158","Sharafuddin Ashraf ","Afghanistan",2014,2019,17,17,5,5,5,0,0,3
"1159","JJ Smit ","Namibia",2019,2020,8,8,5,5,5,0,0,2
"1160","JN Snape ","England",2001,2002,10,10,5,5,5,0,0,2
"1161","CA Soper ","Papau New Guinea",2016,2019,20,20,5,5,5,0,0,2
"1162","ELR Stewart ","South Africa",1993,2002,6,6,5,5,0,5,0,2
"1163","MR Swart ","Netherlands",2011,2014,12,12,5,5,5,0,0,2
"1164","J Theron (SA/USA)",NA,2010,2020,13,13,5,5,5,0,0,2
"1165","I Udana ","Sri Lanka",2012,2020,18,18,5,5,5,0,0,2
"1166","Wajahatullah Wasti ","Pakistan",1999,2000,15,15,5,5,5,0,0,1
"1167","BGK Walker ","New Zealand",2000,2002,11,11,5,5,5,0,0,1
"1168","B Warnapura ","Sri Lanka",1975,1982,12,12,5,5,5,0,0,2
"1169","SR Waters ","Kenya",2008,2011,20,20,5,5,5,0,0,2
"1170","CG Williams ","Namibia",2019,2020,8,8,5,5,5,0,0,2
"1171","GH Worker ","New Zealand",2015,2018,10,10,5,5,5,0,0,3
"1172","GN Yallop ","Australia",1978,1984,30,27,5,5,5,0,0,2
"1173","Ziaur Rahman ","Bangladesh",2013,2014,13,13,5,5,5,0,0,1
"1174","Adnan Mufti ","United Arab Emirates",2017,2018,18,18,4,4,4,0,0,1
"1175","Ahsan Malik ","Netherlands",2011,2014,12,12,4,4,4,0,0,2
"1176","DS Airee ","Nepal",2018,2020,10,10,4,4,4,0,0,1
"1177","Amir Hayat ","United Arab Emirates",2018,2019,9,9,4,4,4,0,0,1
"1178","Anwar Ali ","Pakistan",2013,2016,22,22,4,4,4,0,0,2
"1179","Aqib Ilyas ","Oman",2019,2020,11,11,4,4,4,0,0,2
"1180","JC Archer ","England",2019,2019,14,14,4,4,4,0,0,1
"1181","J Arun Lal ","India",1982,1989,13,13,4,4,4,0,0,1
"1182","Atiq-uz-Zaman ","Pakistan",2000,2000,3,3,4,3,0,3,1,3
"1183","AM Bacher ","South Africa",1997,2005,13,13,4,4,4,0,0,2
"1184","SB Bangar ","India",2002,2004,15,15,4,4,4,0,0,2
"1185","GD Barlow ","England",1976,1977,6,6,4,4,4,0,0,2
"1186","GJ Batty ","England",2002,2009,10,10,4,4,4,0,0,2
"1187","T Bavuma ","South Africa",2016,2020,6,5,4,4,4,0,0,2
"1188","AC Bedade ","India",1994,1994,13,12,4,4,4,0,0,1
"1189","BS Bedi ","India",1974,1979,10,10,4,4,4,0,0,3
"1190","KCG Benjamin ","West Indies",1992,1996,26,26,4,4,4,0,0,2
"1191","TL Best ","West Indies",2004,2014,26,26,4,4,4,0,0,1
"1192","BR Blair ","New Zealand",1982,1986,14,13,4,4,4,0,0,2
"1193","DR Brown (ENG/SCOT)",NA,1997,2007,25,25,4,4,4,0,0,1
"1194","HR Bryan ","West Indies",1999,1999,15,15,4,4,4,0,0,1
"1195","IP Butchart ","Zimbabwe",1983,1995,20,20,4,4,4,0,0,1
"1196","GD Campbell ","Australia",1989,1990,12,12,4,4,4,0,0,1
"1197","KED Carroll ","Ireland",2007,2007,6,6,4,4,4,0,0,2
"1198","PVD Chameera ","Sri Lanka",2015,2019,23,23,4,4,4,0,0,1
"1199","BB Chari ","Zimbabwe",2015,2019,11,10,4,3,2,1,1,2
"1200","DN Chudasama ","Kenya",1996,1999,20,20,4,4,4,0,0,1
"1201","ST Clarke ","West Indies",1978,1982,10,10,4,4,4,0,0,1
"1202","GJ Cosier ","Australia",1975,1979,9,8,4,4,4,0,0,2
"1203","TK Curran ","England",2017,2020,20,20,4,4,4,0,0,1
"1204","PC de Silva ","Sri Lanka",2014,2017,7,7,4,4,4,0,0,2
"1205","GR Dilley ","England",1979,1988,36,36,4,4,4,0,0,2
"1206","FH Edwards ","West Indies",2003,2009,50,49,4,4,4,0,0,1
"1207","SA Edwards ","Netherlands",2018,2019,4,4,4,4,0,4,0,3
"1208","D Elgar ","South Africa",2012,2018,8,8,4,4,4,0,0,2
"1209","FM Engineer ","India",1974,1975,5,5,4,3,0,3,1,1
"1210","KWR Fletcher ","England",1971,1982,24,23,4,4,4,0,0,1
"1211","DR Flynn ","New Zealand",2008,2012,20,20,4,4,4,0,0,1
"1212","PJ Forrest ","Australia",2012,2012,15,15,4,4,4,0,0,1
"1213","RC Fredericks ","West Indies",1973,1977,12,12,4,4,4,0,0,1
"1214","HJW Gardiner ","Scotland",2013,2015,11,11,4,4,4,0,0,2
"1215","HM Goonatilleke ","Sri Lanka",1982,1982,6,6,4,0,0,0,4,2
"1216","TR Gripper ","Zimbabwe",2001,2003,8,8,4,4,4,0,0,2
"1217","Hammad Azam ","Pakistan",2011,2015,11,11,4,4,4,0,0,2
"1218","Haseeb Amjad ","Hong Kong",2014,2016,7,7,4,4,4,0,0,1
"1219","BF Hastings ","New Zealand",1973,1975,11,11,4,4,4,0,0,2
"1220","M Hayward ","South Africa",1998,2002,21,21,4,4,4,0,0,1
"1221","MC Henriques ","Australia",2009,2017,11,11,4,4,4,0,0,2
"1222","PA Hitchcock ","New Zealand",2002,2008,14,13,4,4,4,0,0,1
"1223","RD Jackman ","England",1974,1983,15,15,4,4,4,0,0,1
"1224","SC Joseph ","West Indies",2000,2005,13,13,4,4,4,0,0,1
"1225","BD Julien ","West Indies",1973,1977,12,12,4,4,4,0,0,1
"1226","S Jyoti ","Canada",2006,2010,14,13,4,4,4,0,0,1
"1227","Kaleemullah ","Oman",2019,2020,9,9,4,4,4,0,0,2
"1228","RB Kanhai ","West Indies",1973,1975,7,7,4,4,4,0,0,1
"1229","MF Kent ","Australia",1981,1981,5,5,4,4,4,0,0,2
"1230","RD King ","West Indies",1998,2005,50,50,4,4,4,0,0,1
"1231","RK Kleinveldt ","South Africa",2013,2013,10,10,4,4,4,0,0,2
"1232","A Kuruvilla ","India",1997,1997,25,25,4,4,4,0,0,1
"1233","RP Lefebvre ","Netherlands",1996,2003,11,11,4,4,4,0,0,1
"1234","RT Lyons ","Scotland",2006,2010,25,25,4,4,4,0,0,1
"1235","WK McCallan ","Ireland",2006,2009,39,37,4,4,4,0,0,1
"1236","MJ McClenaghan ","New Zealand",2013,2016,48,46,4,4,4,0,0,1
"1237","A McGrath ","England",2003,2004,14,13,4,4,4,0,0,2
"1238","MW Machan ","Scotland",2013,2016,23,22,4,4,4,0,0,1
"1239","AO Malhotra ","India",1982,1986,20,20,4,4,4,0,0,1
"1240","AA Mallett ","Australia",1971,1975,9,9,4,4,4,0,0,1
"1241","WP Masakadza ","Zimbabwe",2015,2018,17,17,4,4,4,0,0,2
"1242","AD Mascarenhas ","England",2007,2009,20,20,4,4,4,0,0,2
"1243","MJ Mason ","New Zealand",2003,2010,26,25,4,4,4,0,0,1
"1244","MP Maynard ","England",1994,2000,14,13,4,4,4,0,0,1
"1245","G Miller ","England",1977,1984,25,25,4,4,4,0,0,2
"1246","Mohsin Kamal ","Pakistan",1984,1989,19,19,4,4,4,0,0,1
"1247","Mominul Haque ","Bangladesh",2012,2018,28,28,4,4,4,0,0,1
"1248","PWA Mulder ","South Africa",2017,2019,10,10,4,4,4,0,0,2
"1249","Nasir Jamal ","Afghanistan",2014,2018,16,15,4,4,4,0,0,2
"1250","EO Odumbe ","Kenya",1996,1996,8,8,4,4,4,0,0,1
"1251","GAHM Parkar ","India",1982,1984,10,8,4,4,4,0,0,2
"1252","MD Patel ","United States of America",2019,2020,13,13,4,4,3,1,0,1
"1253","SS Pathirana ","Sri Lanka",2015,2017,18,18,4,4,4,0,0,2
"1254","ASA Perera ","Sri Lanka",1998,2001,20,20,4,4,4,0,0,2
"1255","NO Perry ","West Indies",1999,2000,21,21,4,4,4,0,0,3
"1256","MJ Petrie ","Scotland",2009,2009,4,4,4,3,0,3,1,2
"1257","AM Phangiso ","South Africa",2013,2016,21,21,4,4,4,0,0,1
"1258","IL Philip ","Scotland",1999,1999,3,3,4,4,4,0,0,3
"1259","Qasim Umar ","Pakistan",1983,1987,31,30,4,4,4,0,0,1
"1260","V Rathour ","India",1996,1997,7,7,4,4,4,0,0,2
"1261","PWE Rawson ","Zimbabwe",1983,1987,10,10,4,4,4,0,0,2
"1262","Raza-ur-Rehman ","Canada",2013,2014,6,6,4,4,4,0,0,4
"1263","V Razdan ","India",1989,1990,3,3,4,4,4,0,0,2
"1264","JA Richardson ","Australia",2018,2020,13,13,4,4,4,0,0,1
"1265","MJG Rippon ","Netherlands",2013,2018,6,6,4,4,4,0,0,1
"1266","RD Robinson ","Australia",1977,1977,2,2,4,3,0,3,1,4
"1267","RL Sanghvi ","India",1998,1998,10,10,4,4,4,0,0,2
"1268","Shahid Nazir ","Pakistan",1996,2000,17,17,4,4,4,0,0,1
"1269","A Shahzad ","England",2010,2011,11,11,4,4,4,0,0,2
"1270","Sikander Bakht ","Pakistan",1977,1989,27,27,4,4,4,0,0,1
"1271","RB Simpson ","Australia",1978,1978,2,2,4,4,4,0,0,2
"1272","GM Strydom ","Zimbabwe",2006,2006,12,12,4,4,4,0,0,2
"1273","Tareq Aziz ","Bangladesh",2002,2004,10,10,4,4,4,0,0,1
"1274","R Telemachus ","South Africa",1998,2006,37,37,4,4,4,0,0,1
"1275","S Thuraisingam ","Canada",2003,2008,10,10,4,4,4,0,0,2
"1276","T Thushara ","Sri Lanka",2008,2010,38,38,4,4,4,0,0,1
"1277","DT Tiripano ","Zimbabwe",2014,2020,34,33,4,4,4,0,0,1
"1278","MK Tiwary ","India",2008,2015,12,11,4,4,4,0,0,3
"1279","G Toka ","Papau New Guinea",2019,2019,7,7,4,4,4,0,0,2
"1280","CT Tremlett ","England",2005,2011,15,15,4,4,4,0,0,1
"1281","RJ Trott ","Bermuda",2007,2009,11,11,4,4,4,0,0,1
"1282","PCR Tufnell ","England",1990,1997,20,20,4,4,4,0,0,2
"1283","Usman Limbada ","Canada",2010,2014,11,11,4,4,4,0,0,2
"1284","RH Vance ","New Zealand",1988,1989,8,8,4,4,4,0,0,2
"1285","RE van der Merwe (NL/SA)",NA,2009,2019,15,15,4,4,4,0,0,1
"1286","M van Jaarsveld ","South Africa",2002,2004,11,11,4,4,4,0,0,1
"1287","M van Schoor ","Namibia",2003,2003,5,5,4,4,0,4,0,2
"1288","JTC Vaughan ","New Zealand",1992,1996,18,18,4,4,4,0,0,1
"1289","S Venkataraghavan ","India",1974,1983,15,15,4,4,4,0,0,1
"1290","R Vijay Bharadwaj ","India",1999,2002,10,10,4,4,4,0,0,1
"1291","JM Vince ","England",2015,2019,13,13,4,4,4,0,0,2
"1292","BV Vitori ","Zimbabwe",2011,2018,24,24,4,4,4,0,0,1
"1293","RM West ","Ireland",2008,2009,10,9,4,4,4,0,0,1
"1294","P Willey ","England",1977,1986,26,26,4,4,4,0,0,1
"1295","BA Williams ","Australia",2002,2004,25,24,4,4,4,0,0,2
"1296","JW Wilson ","New Zealand",1993,2005,6,6,4,4,4,0,0,2
"1297","Aarif Sheikh ","Nepal",2018,2020,10,10,3,3,3,0,0,2
"1298","Abid Ali ","Pakistan",2019,2019,4,4,3,3,3,0,0,2
"1299","MR Adair ","Ireland",2019,2020,12,12,3,3,3,0,0,1
"1300","CJ Adams ","England",1998,2000,5,5,3,3,3,0,0,1
"1301","Adeel Raja ","Netherlands",2002,2011,21,21,3,3,3,0,0,1
"1302","Adnan Akmal ","Pakistan",2011,2012,5,5,3,3,0,3,0,1
"1303","RG Aga ","Kenya",2004,2014,12,12,3,3,3,0,0,1
"1304","Aizaz Khan ","Hong Kong",2014,2018,19,19,3,3,3,0,0,1
"1305","MW Alleyne ","England",1999,2000,10,10,3,3,3,0,0,1
"1306","TR Ambrose ","England",2008,2008,5,5,3,3,0,3,0,1
"1307","J Anderson ","Ireland",2014,2016,8,8,3,3,3,0,0,2
"1308","KJ Arnott ","Zimbabwe",1987,1993,13,13,3,3,3,0,0,1
"1309","Azeem Hafeez ","Pakistan",1983,1985,15,15,3,3,3,0,0,2
"1310","SV Bahutule ","India",1997,2003,8,8,3,3,3,0,0,2
"1311","WD Balaji Rao ","Canada",2008,2011,10,10,3,3,3,0,0,1
"1312","ST Banerjee ","India",1991,1992,6,6,3,3,3,0,0,1
"1313","AB Barath ","West Indies",2010,2012,14,13,3,3,3,0,0,1
"1314","OO Bascome ","Bermuda",2008,2008,6,6,3,3,3,0,0,1
"1315","JP Behrendorff ","Australia",2019,2019,11,11,3,3,3,0,0,1
"1316","DM Benkenstein ","South Africa",1998,2002,23,23,3,3,3,0,0,1
"1317","HK Bennett ","New Zealand",2010,2020,19,19,3,3,3,0,0,1
"1318","STR Binny ","India",2014,2015,14,12,3,3,3,0,0,2
"1319","RJ Blakey ","England",1992,1993,3,3,3,2,0,2,1,2
"1320","SM Boland ","Australia",2016,2016,14,14,3,3,3,0,0,1
"1321","LE Bosman (Afr/SA)",NA,2006,2010,14,14,3,3,3,0,0,2
"1322","DAJ Bracewell ","New Zealand",2011,2019,19,19,3,3,3,0,0,1
"1323","KC Brathwaite ","West Indies",2016,2017,10,10,3,3,3,0,0,1
"1324","CPS Chauhan ","India",1978,1981,7,7,3,3,3,0,0,1
"1325","Chirag Suri ","United Arab Emirates",2018,2020,17,17,3,3,3,0,0,1
"1326","NE Clarke ","Netherlands",1996,1996,5,5,3,3,3,0,0,1
"1327","D Dasgupta ","India",2001,2001,5,5,3,2,0,2,1,1
"1328","AG Davies ","Scotland",1999,1999,5,5,3,2,0,2,1,2
"1329","AP Devcich ","New Zealand",2013,2016,12,12,3,3,3,0,0,1
"1330","LHD Dilhara ","Sri Lanka",2005,2013,9,9,3,3,3,0,0,1
"1331","DR Doshi ","India",1980,1982,15,15,3,3,3,0,0,1
"1332","Ehsan Khan ","Hong Kong",2016,2018,15,15,3,3,3,0,0,2
"1333","CE Eksteen ","South Africa",1991,1994,6,6,3,3,3,0,0,1
"1334","AM Ellis ","New Zealand",2012,2013,15,15,3,3,3,0,0,2
"1335","PA Emery ","Australia",1994,1994,1,1,3,3,0,3,0,3
"1336","JJ Esmeijer ","Netherlands",2002,2003,6,6,3,3,3,0,0,2
"1337","GM Ewing ","Zimbabwe",2004,2005,7,7,3,3,3,0,0,2
"1338","Faisal Hossain ","Bangladesh",2004,2010,6,6,3,3,3,0,0,1
"1339","Faisal Iqbal ","Pakistan",2000,2006,18,18,3,3,3,0,0,1
"1340","TCB Fernando ","Sri Lanka",2001,2003,17,17,3,3,3,0,0,2
"1341","BT Foakes ","England",2019,2019,1,1,3,2,0,2,1,3
"1342","CR Foggo ","Bermuda",2008,2008,4,4,3,3,3,0,0,2
"1343","JN Frylinck ","Namibia",2019,2020,8,8,3,3,3,0,0,2
"1344","OD Gibson ","West Indies",1995,1997,15,15,3,3,3,0,0,1
"1345","DR Gilbert ","Australia",1986,1986,14,14,3,3,3,0,0,1
"1346","AH Gray ","West Indies",1985,1991,25,25,3,3,3,0,0,1
"1347","EJ Gray ","New Zealand",1984,1988,10,10,3,3,3,0,0,2
"1348","PW Gunaratne ","Sri Lanka",2002,2003,23,23,3,3,3,0,0,1
"1349","Haroon Rasheed ","Pakistan",1977,1982,12,12,3,3,3,0,0,1
"1350","Hazratullah Zazai ","Afghanistan",2018,2019,16,15,3,3,3,0,0,1
"1351","DW Headley ","England",1996,1999,13,13,3,3,3,0,0,1
"1352","SP Heaney ","Canada",2006,2006,4,4,3,3,3,0,0,2
"1353","IG Holland ","United States of America",2019,2020,8,8,3,3,3,0,0,2
"1354","HJ Howarth ","New Zealand",1973,1975,9,9,3,3,3,0,0,1
"1355","Iftikhar Ahmed ","Pakistan",2015,2019,4,4,3,3,3,0,0,1
"1356","PJ Ingram ","New Zealand",2010,2010,8,8,3,3,3,0,0,1
"1357","Iqbal Qasim ","Pakistan",1977,1988,15,15,3,3,3,0,0,1
"1358","SD Jack ","South Africa",1994,1995,2,2,3,3,3,0,0,2
"1359","PA Jaques ","Australia",2006,2007,6,6,3,3,3,0,0,1
"1360","Joginder Sharma ","India",2004,2007,4,4,3,3,3,0,0,1
"1361","MA Jones ","Scotland",2018,2019,8,8,3,3,3,0,0,1
"1362","Junaid Siddiqui ","Canada",2011,2014,9,9,3,3,3,0,0,1
"1363","SKW Kelly ","Bermuda",2006,2009,10,10,3,3,3,0,0,1
"1364","D Keulder ","Namibia",2003,2003,6,6,3,3,3,0,0,2
"1365","AR Khurasiya ","India",1999,2001,12,12,3,3,3,0,0,1
"1366","Khurram Chohan ","Canada",2009,2014,25,24,3,3,3,0,0,1
"1367","Khurram Manzoor ","Pakistan",2008,2009,7,7,3,3,3,0,0,1
"1368","BA King ","West Indies",2019,2020,4,4,3,3,3,0,0,1
"1369","LJ Koen ","South Africa",1997,2000,5,5,3,3,3,0,0,2
"1370","DB Kotze ","Namibia",2003,2003,6,6,3,3,3,0,0,1
"1371","AP Kuiper ","South Africa",1991,1996,25,25,3,3,3,0,0,1
"1372","CBRLS Kumara ","Sri Lanka",2017,2019,13,13,3,3,3,0,0,1
"1373","T Kumaran ","India",1999,2000,8,8,3,3,3,0,0,1
"1374","JL Langer ","Australia",1994,1997,8,8,3,2,1,1,1,1
"1375","D Lloyd ","England",1973,1980,8,8,3,3,3,0,0,1
"1376","BP Loots ","Netherlands",2010,2011,7,7,3,3,3,0,0,2
"1377","CA Lynn ","Australia",2017,2018,4,4,3,3,3,0,0,2
"1378","RB McCosker ","Australia",1975,1982,14,14,3,3,3,0,0,1
"1379","AJ McKay ","New Zealand",2010,2012,19,19,3,3,3,0,0,1
"1380","N Madziva ","Zimbabwe",2014,2016,12,12,3,3,3,0,0,1
"1381","MAWR Madurasinghe ","Sri Lanka",1988,1992,12,12,3,3,3,0,0,1
"1382","Majid Khan ","Pakistan",1973,1982,23,23,3,3,3,0,0,1
"1383","JN Malan ","South Africa",2020,2020,3,3,3,3,3,0,0,3
"1384","G Malla ","Nepal",2018,2020,10,10,3,3,3,0,0,1
"1385","A Martin ","West Indies",2011,2011,9,9,3,3,3,0,0,1
"1386","TBA May ","Australia",1987,1995,47,47,3,3,3,0,0,2
"1387","M Mbangwa ","Zimbabwe",1996,2002,29,29,3,3,3,0,0,1
"1388","Mohammad Nadeem ","Oman",2019,2020,10,10,3,3,3,0,0,1
"1389","Mohammad Saifuddin ","Bangladesh",2017,2020,22,22,3,3,3,0,0,1
"1390","JN Mohammed ","West Indies",2011,2018,28,27,3,3,3,0,0,1
"1391","R Murray ","Zimbabwe",2018,2018,5,5,3,3,0,3,0,1
"1392","Mushtaq Mohammad ","Pakistan",1973,1978,10,10,3,3,3,0,0,1
"1393","JD Nel ","Scotland",2006,2010,19,19,3,3,3,0,0,1
"1394","RAP Nissanka ","Sri Lanka",2001,2003,23,23,3,3,3,0,0,1
"1395","Nurul Hasan ","Bangladesh",2016,2016,2,2,3,2,0,2,1,3
"1396","LN Onyango ","Kenya",1996,2014,29,29,3,3,3,0,0,1
"1397","ARM Opatha ","Sri Lanka",1975,1979,5,5,3,3,3,0,0,2
"1398","MS Panesar ","England",2007,2007,26,26,3,3,3,0,0,1
"1399","MA Parker ","Scotland",2010,2010,10,10,3,3,3,0,0,1
"1400","JL Pattinson ","Australia",2011,2015,15,15,3,3,3,0,0,1
"1401","RK Paudel ","Nepal",2018,2020,5,5,3,3,3,0,0,1
"1402","RR Powar ","India",2004,2007,31,30,3,3,3,0,0,1
"1403","MR Pydanna ","West Indies",1980,1983,3,3,3,2,0,2,1,1
"1404","S Ramesh ","India",1999,1999,24,23,3,3,3,0,0,1
"1405","SHA Rance ","New Zealand",2017,2017,2,2,3,3,3,0,0,3
"1406","Rashid Khan ","Pakistan",1980,1985,29,28,3,3,3,0,0,1
"1407","AJ Redmond ","New Zealand",2009,2010,6,6,3,3,3,0,0,1
"1408","RB Reid ","New Zealand",1988,1991,9,9,3,3,3,0,0,1
"1409","FL Reifer ","West Indies",1997,2009,8,8,3,3,3,0,0,1
"1410","GR Robertson ","Australia",1994,1998,13,13,3,3,3,0,0,1
"1411","DB Rundle ","South Africa",1994,1994,2,2,3,3,3,0,0,2
"1412","NA Saini ","India",2019,2020,5,5,3,3,3,0,0,2
"1413","Saleem Jaffar ","Pakistan",1986,1990,39,39,3,3,3,0,0,1
"1414","DP Samaraweera ","Sri Lanka",1993,1994,5,5,3,3,3,0,0,2
"1415","MMC Schewe ","Netherlands",1996,1996,5,5,3,2,0,2,1,3
"1416","E Schiferli ","Netherlands",2002,2013,30,30,3,3,3,0,0,1
"1417","Shamsur Rahman ","Bangladesh",2013,2014,10,10,3,3,3,0,0,2
"1418","MD Shanaka ","Sri Lanka",2016,2019,22,22,3,3,3,0,0,1
"1419","KV Sharma ","India",2014,2014,2,2,3,3,3,0,0,2
"1420","VRV Singh ","India",2006,2006,2,2,3,3,3,0,0,2
"1421","TT Smart ","Hong Kong",2004,2004,2,2,3,3,1,2,0,2
"1422","CJ Smith ","Bermuda",2006,2007,12,12,3,3,3,0,0,2
"1423","S Snater ","Netherlands",2018,2018,2,2,3,3,3,0,0,2
"1424","Sohail Khan ","Pakistan",2008,2016,13,13,3,3,3,0,0,1
"1425","CB Sole ","Scotland",2016,2018,11,11,3,3,3,0,0,2
"1426","MC Sorensen ","Ireland",2013,2016,13,12,3,3,3,0,0,1
"1427","DA Stirling ","New Zealand",1984,1984,6,6,3,3,3,0,0,1
"1428","PC Strydom ","South Africa",2000,2000,10,10,3,3,3,0,0,2
"1429","R Strydom ","Ireland",2008,2008,9,8,3,3,3,0,0,1
"1430","Tanveer Ahmed ","Hong Kong",2016,2018,6,6,3,3,3,0,0,2
"1431","Tanwir Afzal ","Hong Kong",2014,2018,20,20,3,3,3,0,0,1
"1432","APB Tennekoon ","Sri Lanka",1975,1979,4,4,3,3,3,0,0,1
"1433","SN Thakur ","India",2017,2020,11,11,3,3,3,0,0,1
"1434","AJ Traicos ","Zimbabwe",1983,1993,27,27,3,3,3,0,0,1
"1435","A Turner ","Australia",1975,1975,6,6,3,3,3,0,0,2
"1436","Usman Ghani ","Afghanistan",2014,2017,15,15,3,3,3,0,0,1
"1437","Usman Shinwari ","Pakistan",2017,2019,17,17,3,3,3,0,0,2
"1438","JJ van der Wath ","South Africa",2006,2007,10,10,3,3,3,0,0,1
"1439","K Verreynne ","South Africa",2020,2020,3,3,3,3,3,0,0,3
"1440","GR Viswanath ","India",1974,1982,25,25,3,3,3,0,0,1
"1441","Waheed Ahmed ","United Arab Emirates",2019,2020,5,5,3,3,3,0,0,1
"1442","Waqas Barkat ","Hong Kong",2014,2018,10,10,3,3,3,0,0,1
"1443","SM Warnapura ","Sri Lanka",2007,2008,3,3,3,3,3,0,0,2
"1444","PN Webb ","New Zealand",1983,1984,5,5,3,3,0,3,0,1
"1445","K Weeraratne ","Sri Lanka",2000,2008,15,15,3,3,3,0,0,1
"1446","DS Wesonga ","Kenya",2010,2011,4,4,3,3,3,0,0,2
"1447","S Wettimuny ","Sri Lanka",1982,1987,35,35,3,3,3,0,0,1
"1448","BTJ Wheal ","Scotland",2016,2019,13,13,3,3,3,0,0,1
"1449","SG Whittingham ","Scotland",2017,2019,5,5,3,3,3,0,0,1
"1450","KIW Wijegunawardene ","Sri Lanka",1988,1992,26,26,3,3,3,0,0,1
"1451","RA Woolmer ","England",1972,1976,6,6,3,3,3,0,0,1
"1452","Jai P Yadav ","India",2002,2005,12,12,3,3,3,0,0,2
"1453","Zahoor Khan ","United Arab Emirates",2017,2019,17,17,3,3,3,0,0,1
"1454","M Zondeki (Afr/SA)",NA,2002,2008,13,13,3,3,3,0,0,1
"1455","Aamir Kaleem ","Oman",2019,2019,2,2,2,2,2,0,0,1
"1456","Aaron Jones ","United States of America",2019,2020,13,13,2,2,2,0,0,1
"1457","Abdur Rauf ","Pakistan",2008,2008,4,4,2,2,2,0,0,1
"1458","Aizaz Cheema ","Pakistan",2011,2012,14,14,2,2,2,0,0,1
"1459","PJW Allott ","England",1982,1985,13,13,2,2,2,0,0,1
"1460","SW Ambris ","West Indies",2017,2020,13,13,2,2,2,0,0,1
"1461","DL Amiss ","England",1972,1977,18,17,2,2,2,0,0,1
"1462","JO Angara ","Kenya",1997,2003,17,17,2,2,2,0,0,1
"1463","SA Ankola ","India",1989,1997,20,20,2,2,2,0,0,1
"1464","GG Arnold ","England",1972,1975,14,13,2,2,2,0,0,1
"1465","TD Astle ","New Zealand",2017,2019,9,9,2,2,2,0,0,1
"1466","Athar Ali Khan ","Bangladesh",1988,1998,19,19,2,2,2,0,0,1
"1467","Azam Khan ","Pakistan",1996,1998,6,6,2,2,2,0,0,1
"1468","Azhar Hossain ","Bangladesh",1988,1990,7,7,2,2,2,0,0,1
"1469","Azhar Saeed ","United Arab Emirates",1994,1996,7,7,2,2,2,0,0,1
"1470","SJ Baard ","Namibia",2019,2020,8,8,2,2,2,0,0,1
"1471","Badal Singh ","Oman",2020,2020,2,2,2,2,2,0,0,2
"1472","S Badrinath ","India",2008,2011,7,7,2,2,2,0,0,2
"1473","IPP Batuwitarachchi ","United Arab Emirates",2008,2008,2,2,2,2,2,0,0,2
"1474","AR Berenger ","United Arab Emirates",2014,2015,10,10,2,2,2,0,0,1
"1475","RA Bhatti ","Canada",2011,2011,1,1,2,2,0,2,0,2
"1476","RL Bhudia ","Kenya",2008,2009,5,5,2,2,2,0,0,1
"1477","MP Bicknell ","England",1990,1991,7,7,2,2,2,0,0,1
"1478","Bilal Asif ","Pakistan",2015,2015,3,3,2,2,2,0,0,2
"1479","Bilawal Bhatti ","Pakistan",2013,2015,10,10,2,2,2,0,0,1
"1480","DCC Borden ","Bermuda",2006,2008,12,12,2,2,2,0,0,1
"1481","GE Bradburn ","New Zealand",1990,2001,11,11,2,2,2,0,0,1
"1482","RJ Bright ","Australia",1974,1986,11,11,2,2,2,0,0,1
"1483","VR Brown ","New Zealand",1988,1988,3,3,2,2,2,0,0,1
"1484","PA Browne ","West Indies",2008,2008,5,5,2,2,0,2,0,1
"1485","MG Burmester ","Zimbabwe",1992,1995,8,8,2,2,2,0,0,1
"1486","JA Burns ","Australia",2015,2015,6,6,2,2,2,0,0,1
"1487","IW Callen ","Australia",1978,1982,5,5,2,2,2,0,0,1
"1488","J Cameron-Dow ","Ireland",2019,2019,4,4,2,2,2,0,0,1
"1489","MA Carberry ","England",2013,2014,6,5,2,2,2,0,0,1
"1490","JJ Celestine ","Bermuda",2007,2008,8,8,2,2,2,0,0,1
"1491","DR Chumney ","Canada",2003,2007,21,21,2,2,2,0,0,1
"1492","PG Coman ","New Zealand",1973,1974,3,3,2,2,2,0,0,1
"1493","G Cook ","England",1981,1983,6,6,2,2,2,0,0,1
"1494","NGB Cook ","England",1984,1989,3,3,2,2,2,0,0,1
"1495","BN Cooper ","Netherlands",2013,2019,8,8,2,2,2,0,0,1
"1496","JP Crawley ","England",1994,1999,13,13,2,1,1,0,1,1
"1497","DJ Cullen ","Australia",2006,2006,5,5,2,2,2,0,0,1
"1498","D Daesrath ","Canada",2012,2013,4,4,2,2,2,0,0,2
"1499","Danish Kaneria ","Pakistan",2001,2007,18,18,2,2,2,0,0,1
"1500","HT Davis ","New Zealand",1994,1997,11,11,2,2,2,0,0,1
"1501","AC Dawson ","South Africa",1998,2004,19,19,2,2,2,0,0,1
"1502","RP de Groen ","New Zealand",1993,1994,12,12,2,2,2,0,0,1
"1503","PA Desai ","Canada",2010,2014,13,13,2,2,2,0,0,1
"1504","GRA de Silva ","Sri Lanka",1975,1982,6,6,2,2,2,0,0,1
"1505","MW Douglas ","New Zealand",1994,1995,6,6,2,2,2,0,0,1
"1506","TM Dowlin ","West Indies",2009,2010,11,11,2,2,2,0,0,1
"1507","KG Duers ","Zimbabwe",1992,1992,6,6,2,2,2,0,0,1
"1508","SF Dukanwala ","United Arab Emirates",1996,1996,5,5,2,2,2,0,0,1
"1509","CI Dunusinghe ","Sri Lanka",1995,1995,1,1,2,1,0,1,1,2
"1510","NR Dyer ","Scotland",1999,1999,5,5,2,2,2,0,0,1
"1511","KA Edwards ","West Indies",2011,2014,16,16,2,2,2,0,0,1
"1512","Ehsan Nawaz ","Hong Kong",2014,2018,12,12,2,2,2,0,0,1
"1513","RM Ellison ","England",1984,1986,14,14,2,2,2,0,0,2
"1514","EA Essop-Adam ","Zimbabwe",1992,1992,1,1,2,2,2,0,0,2
"1515","Fahim Muntasir ","Bangladesh",2001,2002,3,3,2,2,2,0,0,1
"1516","Fareed Ahmad ","Afghanistan",2014,2017,5,4,2,2,2,0,0,1
"1517","Faruk Ahmed ","Bangladesh",1988,1999,7,7,2,2,2,0,0,1
"1518","Fayyaz Butt ","Oman",2019,2019,5,5,2,2,2,0,0,1
"1519","KHRK Fernando ","Sri Lanka",2002,2006,7,7,2,2,2,0,0,1
"1520","AN French ","Hong Kong",2004,2004,2,2,2,2,2,0,0,1
"1521","D Gamage ","Sri Lanka",2003,2003,3,3,2,2,2,0,0,1
"1522","JC Gamage ","Sri Lanka",1995,1995,4,4,2,2,2,0,0,1
"1523","PLS Gamage ","Sri Lanka",2014,2017,9,9,2,2,2,0,0,1
"1524","KD Ghavri ","India",1975,1981,19,19,2,2,2,0,0,1
"1525","GJ Gilmour ","Australia",1974,1975,5,5,2,2,2,0,0,1
"1526","DM Gondaria ","Kenya",2013,2013,2,2,2,2,2,0,0,1
"1527","TG Gordon ","Canada",2011,2011,5,5,2,2,2,0,0,1
"1528","K Gore ","United States of America",2019,2020,10,10,2,2,2,0,0,1
"1529","Z Groenewald ","Namibia",2019,2019,4,4,2,2,2,0,0,1
"1530","TGJ Gruijters ","Netherlands",2010,2013,5,5,2,2,2,0,0,1
"1531","DR Hadlee ","New Zealand",1973,1976,11,11,2,2,2,0,0,1
"1532","Hafizur Rahman ","Bangladesh",1986,1986,2,2,2,2,0,2,0,1
"1533","PL Harris ","South Africa",2008,2008,3,3,2,2,2,0,0,1
"1534","C Hemraj ","West Indies",2018,2018,6,6,2,2,2,0,0,2
"1535","BE Hendricks ","South Africa",2019,2020,7,5,2,2,2,0,0,1
"1536","RO Hinds ","West Indies",2001,2004,14,14,2,2,2,0,0,1
"1537","ND Hirwani ","India",1988,1992,18,18,2,2,2,0,0,1
"1538","LG Howell ","New Zealand",1998,1998,12,12,2,2,2,0,0,1
"1539","GW Humpage ","England",1981,1981,3,3,2,2,0,2,0,1
"1540","EH Hutchinson ","United States of America",2019,2020,6,6,2,2,2,0,0,1
"1541","N Ifill ","Canada",2003,2006,4,4,2,2,2,0,0,1
"1542","Ijaz Faqih ","Pakistan",1980,1988,27,27,2,2,2,0,0,1
"1543","IT Iqbal ","Kenya",1996,1996,3,3,2,2,0,2,0,2
"1544","AJ Ireland ","Zimbabwe",2005,2007,26,26,2,2,2,0,0,1
"1545","Irfan Ahmed ","Hong Kong",2008,2014,6,6,2,2,2,0,0,2
"1546","KA Jamieson ","New Zealand",2020,2020,2,2,2,2,2,0,0,2
"1547","LR Johnson ","West Indies",2008,2015,6,6,2,2,2,0,0,1
"1548","SMS Kaluperuma ","Sri Lanka",1988,1988,2,2,2,2,2,0,0,1
"1549","FJ Klaassen ","Netherlands",2018,2019,4,4,2,2,2,0,0,2
"1550","JJ Krejza ","Australia",2011,2011,8,8,2,2,2,0,0,1
"1551","P Krishnamurthy ","India",1976,1976,1,1,2,1,0,1,1,2
"1552","N Kruger ","Netherlands",2011,2011,2,2,2,2,2,0,0,2
"1553","DS Kulkarni ","India",2014,2016,12,12,2,2,2,0,0,1
"1554","NM Kulkarni ","India",1997,1998,10,10,2,2,2,0,0,1
"1555","RR Kulkarni ","India",1983,1987,10,10,2,2,2,0,0,1
"1556","S Lamichhane ","Nepal",2018,2020,10,10,2,2,2,0,0,1
"1557","B Laughlin ","Australia",2009,2009,5,5,2,2,2,0,0,1
"1558","P Lever ","England",1971,1975,10,9,2,2,2,0,0,1
"1559","GD Lloyd ","England",1996,1998,6,6,2,2,2,0,0,1
"1560","SCG MacGill ","Australia",2000,2000,3,3,2,2,2,0,0,1
"1561","BJ McKechnie ","New Zealand",1975,1981,14,14,2,2,2,0,0,1
"1562","KH MacLeay ","Australia",1983,1987,16,16,2,2,2,0,0,1
"1563","TN Madondo ","Zimbabwe",1998,2001,13,13,2,2,2,0,0,1
"1564","JN Maguire ","Australia",1983,1984,23,21,2,2,2,0,0,1
"1565","I Maraj ","Canada",2003,2003,6,6,2,2,2,0,0,1
"1566","A Maregwede ","Zimbabwe",2003,2005,11,11,2,2,2,0,0,1
"1567","EH Mattis ","West Indies",1981,1981,2,2,2,2,2,0,0,1
"1568","B Mavuta ","Zimbabwe",2018,2019,7,7,2,2,2,0,0,1
"1569","TMK Mawoyo ","Zimbabwe",2006,2014,7,7,2,2,2,0,0,1
"1570","MC Mendis ","Sri Lanka",1995,1995,1,1,2,2,2,0,0,2
"1571","Minhajul Abedin ","Bangladesh",1986,1999,27,27,2,2,2,0,0,1
"1572","Mohammad Kashif ","Netherlands",2006,2010,11,11,2,2,2,0,0,1
"1573","Mohammad Khalil ","Pakistan",2005,2005,3,3,2,2,2,0,0,1
"1574","Mohammad Naim ","Bangladesh",2020,2020,1,1,2,2,2,0,0,2
"1575","Mohammad Shahzad ","United Arab Emirates",2014,2016,6,6,2,2,2,0,0,1
"1576","Mohammed Qasim ","United Arab Emirates",2017,2017,5,5,2,2,2,0,0,1
"1577","Mohibullah Oryakhel ","Afghanistan",2013,2013,2,2,2,2,2,0,0,1
"1578","GMC Mol ","Netherlands",2007,2008,6,6,2,2,2,0,0,2
"1579","HJC Mol ","Netherlands",2002,2008,11,11,2,2,2,0,0,1
"1580","PJK Mooney ","Ireland",2006,2007,4,4,2,2,2,0,0,2
"1581","JE Morris ","England",1990,1991,8,8,2,2,2,0,0,1
"1582","Morshed Ali Khan ","Bangladesh",1998,1998,3,3,2,2,2,0,0,1
"1583","JK Moss ","Australia",1979,1979,1,1,2,2,2,0,0,2
"1584","EMDY Munaweera ","Sri Lanka",2017,2017,2,2,2,2,2,0,0,1
"1585","W Mwayenga ","Zimbabwe",2002,2004,3,3,2,2,2,0,0,1
"1586","SJ Myburgh ","Netherlands",2011,2018,13,13,2,2,2,0,0,1
"1587","Nafees Iqbal ","Bangladesh",2003,2005,16,16,2,2,2,0,0,1
"1588","PG Nana ","East (and Central) Africa",1975,1975,3,3,2,2,2,0,0,1
"1589","Nasir Ahmed ","Bangladesh",1988,1990,7,7,2,1,0,1,1,1
"1590","Naved Latif ","Pakistan",2001,2003,11,11,2,2,2,0,0,1
"1591","Naveen-ul-Haq ","Afghanistan",2016,2019,4,4,2,2,2,0,0,1
"1592","Najmul Hossain Shanto ","Bangladesh",2018,2020,5,5,2,2,2,0,0,2
"1593","Nazmul Islam ","Bangladesh",2018,2018,5,5,2,2,2,0,0,1
"1594","TS Nethula ","New Zealand",2012,2012,5,5,2,2,2,0,0,1
"1595","A Nortje ","South Africa",2019,2020,7,7,2,2,2,0,0,2
"1596","MP O'Dowd ","Netherlands",2019,2019,2,2,2,2,2,0,0,1
"1597","FN Otieno ","Kenya",2010,2010,4,4,2,2,2,0,0,1
"1598","C Overton ","England",2018,2018,1,1,2,2,2,0,0,2
"1599","JV Paranjpe ","India",1998,1998,4,4,2,2,2,0,0,1
"1600","TK Patel ","United States of America",2019,2020,7,7,2,2,2,0,0,1
"1601","D Paterson ","South Africa",2017,2019,4,4,2,2,2,0,0,2
"1602","GA Paterson ","Zimbabwe",1983,1987,10,10,2,2,2,0,0,1
"1603","MDK Perera ","Sri Lanka",2007,2018,13,12,2,2,2,0,0,1
"1604","PDRL Perera ","Sri Lanka",1999,2007,19,19,2,2,2,0,0,1
"1605","Pervez Mir ","Pakistan",1975,1977,3,3,2,2,2,0,0,1
"1606","RG Petrie ","New Zealand",1990,1991,12,12,2,2,2,0,0,1
"1607","OL Pitcher ","Bermuda",2007,2007,5,5,2,2,2,0,0,1
"1608","MW Priest ","New Zealand",1990,1998,18,18,2,2,2,0,0,1
"1609","MW Pringle ","South Africa",1992,1994,17,17,2,2,2,0,0,1
"1610","PM Pushpakumara ","Sri Lanka",2017,2017,2,2,2,2,2,0,0,1
"1611","NV Radford ","England",1988,1988,6,6,2,2,2,0,0,2
"1612","Raees Ahmadzai ","Afghanistan",2009,2010,5,5,2,2,2,0,0,1
"1613","LS Rajput ","India",1985,1987,4,4,2,2,2,0,0,1
"1614","WV Raman ","India",1988,1996,27,27,2,2,2,0,0,1
"1615","S Ranatunga ","Sri Lanka",1994,1996,13,13,2,2,2,0,0,1
"1616","D Ravu ","Papau New Guinea",2017,2019,8,8,2,2,2,0,0,1
"1617","B Reddy ","India",1978,1981,3,3,2,2,0,2,0,1
"1618","IR Redpath ","Australia",1971,1975,5,5,2,2,2,0,0,1
"1619","CP Rizwan ","United Arab Emirates",2019,2020,9,9,2,2,2,0,0,1
"1620","Rizwan-uz-Zaman ","Pakistan",1981,1987,3,3,2,2,2,0,0,2
"1621","GK Robertson ","New Zealand",1981,1989,10,10,2,2,2,0,0,1
"1622","GA Rogers ","Scotland",2006,2008,13,12,2,2,2,0,0,1
"1623","GRJ Roope ","England",1973,1978,8,7,2,2,2,0,0,1
"1624","LG Rowe ","West Indies",1975,1980,11,11,2,2,2,0,0,1
"1625","Rumman Raees ","Pakistan",2017,2018,9,9,2,2,2,0,0,1
"1626","HD Rutherford ","New Zealand",2013,2013,4,4,2,2,2,0,0,1
"1627","Saeed Azad ","Pakistan",1995,1996,4,4,2,2,2,0,0,1
"1628","AK Sah ","Nepal",2018,2018,2,2,2,2,0,2,0,2
"1629","AM Salvi ","India",2003,2003,4,4,2,2,2,0,0,1
"1630","Sameer Zia ","United Arab Emirates",2004,2004,1,1,2,2,2,0,0,2
"1631","Saqib Ali ","United Arab Emirates",2008,2014,5,5,2,2,2,0,0,1
"1632","Saqlain Haider ","United Arab Emirates",2014,2016,5,5,2,1,0,1,1,1
"1633","Sarandeep Singh ","India",2002,2003,5,5,2,2,2,0,0,1
"1634","AF Sattaur ","Canada",2003,2003,3,3,2,2,2,0,0,2
"1635","BM Scholtz ","Namibia",2019,2020,8,8,2,2,2,0,0,2
"1636","S Seeraj ","Canada",2006,2006,1,1,2,2,0,2,0,2
"1637","KF Semple ","West Indies",1999,1999,7,7,2,2,2,0,0,1
"1638","CP Senanayake ","Sri Lanka",1990,1991,7,7,2,2,2,0,0,1
"1639","Shaheen Shah Afridi ","Pakistan",2018,2019,19,18,2,2,2,0,0,1
"1640","Shahid Saeed ","Pakistan",1989,1993,10,10,2,2,2,0,0,1
"1641","Shahid Wasif ","Hong Kong",2016,2018,10,10,2,2,2,0,0,1
"1642","G Sharma ","India",1985,1987,11,11,2,2,2,0,0,1
"1643","TG Shaw ","South Africa",1991,1994,9,9,2,2,2,0,0,1
"1644","MQ Sheikh ","Scotland",2008,2010,7,7,2,2,2,0,0,1
"1645","R Shepherd ","West Indies",2019,2020,5,5,2,2,2,0,0,1
"1646","IT Shillingford ","West Indies",1978,1978,2,2,2,2,2,0,0,1
"1647","DJM Short ","Australia",2018,2020,8,8,2,2,2,0,0,1
"1648","JT Smuts ","South Africa",2020,2020,5,4,2,2,2,0,0,2
"1649","ED Solkar ","India",1974,1976,7,7,2,2,2,0,0,1
"1650","IM Stanger ","Scotland",1999,2006,5,5,2,2,2,0,0,1
"1651","CAH Stevenson ","United States of America",2019,2020,7,7,2,2,2,0,0,1
"1652","GB Stevenson ","England",1980,1981,4,4,2,2,2,0,0,1
"1653","AM Stuart ","Australia",1997,1997,3,3,2,2,2,0,0,2
"1654","Taslim Arif ","Pakistan",1980,1980,2,2,2,1,1,0,1,1
"1655","SP Terry ","Ireland",2016,2016,5,5,2,2,2,0,0,2
"1656","LO Tikolo ","Kenya",1996,1996,3,3,2,2,2,0,0,1
"1657","SS Tiwary ","India",2010,2010,3,3,2,2,2,0,0,1
"1658","RJW Topley ","England",2015,2016,10,10,2,2,2,0,0,1
"1659","GB Troup ","New Zealand",1976,1985,22,22,2,2,2,0,0,1
"1660","TE Tucker ","Bermuda",2008,2009,5,5,2,2,2,0,0,1
"1661","AJ Turner ","Australia",2019,2020,6,6,2,2,2,0,0,1
"1662","KEA Upashantha ","Sri Lanka",1995,2001,12,12,2,2,2,0,0,1
"1663","PS Vaidya ","India",1995,1996,4,4,2,2,2,0,0,1
"1664","JDF Vandersay ","Sri Lanka",2015,2019,12,12,2,2,2,0,0,1
"1665","RF van Oosterom ","Netherlands",1996,2002,3,3,2,2,2,0,0,1
"1666","C Viljoen ","Namibia",2019,2019,2,2,2,2,2,0,0,2
"1667","KDK Vithanage ","Sri Lanka",2013,2014,6,6,2,2,2,0,0,1
"1668","MDJ Walker ","New Zealand",2003,2003,3,3,2,2,2,0,0,1
"1669","HR Walsh (USA/WI)",NA,2019,2020,10,10,2,2,2,0,0,1
"1670","KPJ Warnaweera ","Sri Lanka",1990,1993,6,6,2,2,2,0,0,1
"1671","AS Wassan ","India",1990,1991,9,9,2,2,2,0,0,1
"1672","DS Weerakkody ","Sri Lanka",2017,2017,3,3,2,2,2,0,0,1
"1673","UWMBCA Welegedara ","Sri Lanka",2009,2010,10,9,2,2,2,0,0,1
"1674","JM Wiener ","Australia",1979,1980,7,7,2,2,2,0,0,1
"1675","RGCE Wijesuriya ","Sri Lanka",1982,1985,8,8,2,2,2,0,0,1
"1676","HS Williams ","South Africa",1999,2000,7,7,2,2,2,0,0,2
"1677","PJ Wiseman ","New Zealand",1998,2003,15,14,2,2,2,0,0,1
"1678","RD Woolley ","Australia",1983,1983,4,2,2,1,0,1,1,2
"1679","Yamin Ahmadzai ","Afghanistan",2015,2019,4,4,2,2,2,0,0,1
"1680","Yasir Arafat ","Pakistan",2000,2009,11,11,2,2,2,0,0,1
"1681","B Yograj Singh ","India",1980,1981,6,6,2,2,2,0,0,1
"1682","BE Young ","Australia",1998,1999,6,6,2,2,2,0,0,1
"1683","CA Young ","Ireland",2014,2020,14,13,2,2,2,0,0,1
"1684","Zahid Fazal ","Pakistan",1990,1994,19,19,2,2,2,0,0,1
"1685","Zahoor Elahi ","Pakistan",1996,1997,14,14,2,2,2,0,0,1
"1686","Zulqarnain Haider ","Pakistan",2010,2010,4,4,2,1,0,1,1,2
"1687","NP Kenjige ","United States of America",2019,2020,5,5,1,1,1,0,0,1
"1688","Aamer Hameed ","Pakistan",1977,1978,2,2,1,1,1,0,0,1
"1689","VR Aaron ","India",2011,2014,9,9,1,1,1,0,0,1
"1690","JS Ababu ","Kenya",1999,2006,9,9,1,1,1,0,0,1
"1691","Abdullah Mazari ","Afghanistan",2010,2010,2,2,1,1,1,0,0,1
"1692","Abdul Jabbar ","Canada",2007,2007,2,2,1,1,1,0,0,1
"1693","S Abrahams ","South Africa",2000,2000,1,1,1,1,1,0,0,1
"1694","Abul Hasan ","Bangladesh",2012,2018,7,7,1,1,1,0,0,1
"1695","Abu Hider ","Bangladesh",2018,2018,2,2,1,1,1,0,0,1
"1696","Afzaal Haider ","Hong Kong",2004,2008,4,4,1,1,1,0,0,1
"1697","MA Agarwal ","India",2020,2020,3,3,1,1,1,0,0,1
"1698","JP Agnew ","England",1985,1985,3,3,1,1,1,0,0,1
"1699","KK Ahmed ","India",2018,2019,11,11,1,1,1,0,0,1
"1700","Aijaz Ali ","United States of America",2004,2004,2,2,1,1,1,0,0,1
"1701","Kabir Ali ","England",2003,2006,14,13,1,1,1,0,0,1
"1702","RW Ali ","Kenya",1996,1997,9,9,1,1,1,0,0,1
"1703","DI Allan ","Kenya",2011,2013,5,5,1,1,1,0,0,1
"1704","MJD Allingham ","Scotland",1999,1999,3,3,1,1,1,0,0,1
"1705","Al-Amin Hossain ","Bangladesh",2014,2020,15,15,1,1,1,0,0,1
"1706","S Amarnath ","India",1978,1978,3,3,1,1,1,0,0,1
"1707","MKDI Amerasinghe ","Sri Lanka",2007,2008,8,8,1,1,1,0,0,1
"1708","CR Amini ","Papau New Guinea",2014,2014,2,2,1,1,1,0,0,1
"1709","RW Anderson ","New Zealand",1976,1978,2,2,1,1,1,0,0,1
"1710","Ankur Vasishta ","Hong Kong",2014,2014,4,4,1,1,1,0,0,1
"1711","Arshad Ali ","United Arab Emirates",2004,2008,4,4,1,1,1,0,0,1
"1712","Arshad Laeeq ","United Arab Emirates",1994,1996,6,6,1,1,1,0,0,1
"1713","Asif Masood ","Pakistan",1973,1976,7,7,1,1,1,0,0,1
"1714","RJ Bailey ","England",1985,1990,4,4,1,1,1,0,0,1
"1715","LS Baker ","West Indies",2008,2009,10,9,1,1,1,0,0,1
"1716","Basil Hameed ","United Arab Emirates",2019,2020,6,6,1,1,1,0,0,1
"1717","TC Bastiampillai ","Canada",2007,2014,13,13,1,1,1,0,0,1
"1718","MD Bates ","New Zealand",2012,2012,2,2,1,1,1,0,0,1
"1719","Bazid Khan ","Pakistan",2004,2008,5,5,1,1,1,0,0,1
"1720","MD Bell ","New Zealand",1998,2001,7,7,1,1,1,0,0,1
"1721","MJ Bennett ","Australia",1984,1985,8,8,1,1,1,0,0,1
"1722","Bilal Khan ","Oman",2019,2020,10,10,1,1,1,0,0,1
"1723","K Birkenstock ","Namibia",2019,2020,8,8,1,1,1,0,0,1
"1724","GA Bishop ","Australia",1987,1987,2,2,1,1,1,0,0,1
"1725","J Blackwood ","West Indies",2015,2015,2,2,1,1,1,0,0,1
"1726","TA Blundell ","New Zealand",2020,2020,2,2,1,1,1,0,0,1
"1727","GH Bodi ","South Africa",2007,2007,2,2,1,1,1,0,0,1
"1728","JWHD Boteju ","Sri Lanka",1999,1999,2,2,1,1,1,0,0,1
"1729","JE Brinkley ","Scotland",1999,1999,5,5,1,1,1,0,0,1
"1730","RE Bryson ","South Africa",1997,1997,7,7,1,1,1,0,0,1
"1731","CE Bulfin ","New Zealand",1999,1999,4,4,1,1,1,0,0,1
"1732","SF Burger ","Namibia",2003,2003,2,2,1,1,1,0,0,1
"1733","SJ Cameron ","Scotland",2018,2018,2,2,1,1,1,0,0,1
"1734","TK Canning ","New Zealand",2003,2005,4,4,1,1,1,0,0,1
"1735","HWR Cartwright ","Australia",2017,2017,2,2,1,1,1,0,0,1
"1736","MS Chapman (HKG/NZ)",NA,2015,2020,6,6,1,1,1,0,0,1
"1737","U Chatterjee ","India",1995,1995,3,3,1,1,1,0,0,1
"1738","DB Close ","England",1972,1972,3,3,1,1,1,0,0,1
"1739","RO Collinge ","New Zealand",1973,1978,15,15,1,1,1,0,0,1
"1740","PC Connell ","Ireland",2008,2010,13,12,1,1,1,0,0,1
"1741","SJ Cook ","South Africa",1991,1993,4,4,1,1,1,0,0,1
"1742","GJ Crocker ","Zimbabwe",1992,1993,6,6,1,1,1,0,0,1
"1743","CEH Croft ","West Indies",1977,1981,19,19,1,1,1,0,0,1
"1744","ML Cummins ","West Indies",2014,2017,11,10,1,1,1,0,0,1
"1745","KM Curran ","Zimbabwe",1983,1987,11,11,1,1,1,0,0,1
"1746","BCJ Cutting ","Australia",2013,2014,4,4,1,1,1,0,0,1
"1747","DDP D'Silva ","United Arab Emirates",2019,2020,6,6,1,1,1,0,0,1
"1748","CJ Dala ","South Africa",2018,2018,2,2,1,1,1,0,0,1
"1749","WW Davis ","West Indies",1983,1988,35,35,1,1,1,0,0,1
"1750","BFW de Leede ","Netherlands",2018,2019,3,3,1,1,1,0,0,1
"1751","MH Denness ","England",1973,1975,12,12,1,1,1,0,0,1
"1752","JH Desai ","United States of America",2004,2004,1,1,1,1,1,0,0,1
"1753","DLS de Silva ","Sri Lanka",1979,1979,2,2,1,1,1,0,0,1
"1754","R Dhanraj ","West Indies",1994,1995,6,6,1,1,1,0,0,1
"1755","BJ Diamanti ","New Zealand",2009,2009,1,1,1,1,1,0,0,1
"1756","AB Dinda ","India",2010,2013,13,13,1,1,1,0,0,1
"1757","MJ Di Venuto ","Australia",1997,1997,9,9,1,1,1,0,0,1
"1758","BL D'Oliveira ","England",1971,1972,4,4,1,1,1,0,0,1
"1759","CJ Drum ","New Zealand",1999,1999,5,5,1,1,1,0,0,1
"1760","G Dymock ","Australia",1974,1980,15,14,1,1,1,0,0,1
"1761","RR Emrit ","West Indies",2007,2007,2,2,1,1,1,0,0,1
"1762","Fahad Usman ","United Arab Emirates",2004,2004,2,2,1,1,1,0,0,1
"1763","Fazle Mahmud ","Bangladesh",2018,2018,2,2,1,1,1,0,0,1
"1764","BOP Fernando ","Sri Lanka",2019,2019,6,6,1,1,1,0,0,1
"1765","KADM Fernando ","Sri Lanka",2003,2003,1,1,1,1,1,0,0,1
"1766","J Figy ","United Arab Emirates",2019,2020,2,2,1,1,1,0,0,1
"1767","MV Fleming ","England",1997,1998,11,11,1,1,1,0,0,1
"1768","MJ Fourie ","Ireland",2007,2008,7,6,1,1,1,0,0,1
"1769","PJ Franks ","England",2000,2000,1,1,1,1,1,0,0,1
"1770","RS Gabriel ","West Indies",1984,1984,11,11,1,1,1,0,0,1
"1771","ST Gabriel ","West Indies",2016,2019,25,25,1,1,1,0,0,1
"1772","WCA Ganegama ","Sri Lanka",2001,2006,4,4,1,1,1,0,0,1
"1773","TN Garwe ","Zimbabwe",2009,2009,1,1,1,1,1,0,0,1
"1774","SP Gauchan ","Nepal",2018,2018,1,1,1,1,1,0,0,1
"1775","Gazi Ashraf ","Bangladesh",1986,1990,7,7,1,1,1,0,0,1
"1776","B Geeves ","Australia",2008,2009,2,2,1,1,1,0,0,1
"1777","SC Getkate ","Ireland",2019,2019,3,3,1,1,1,0,0,1
"1778","N Gifford ","England",1985,1985,2,2,1,1,1,0,0,1
"1779","BD Glover ","Netherlands",2019,2019,1,1,1,1,1,0,0,1
"1780","SF Graf ","Australia",1980,1981,11,11,1,1,1,0,0,1
"1781","AP Grayson ","England",2000,2001,2,2,1,1,1,0,0,1
"1782","Gurkeerat Singh ","India",2016,2016,3,3,1,1,1,0,0,1
"1783","HF Gurney ","England",2014,2014,10,10,1,1,1,0,0,1
"1784","Gursharan Singh ","India",1990,1990,1,1,1,1,1,0,0,1
"1785","AM Guruge ","United Arab Emirates",2014,2015,7,7,1,1,1,0,0,1
"1786","RS Haire ","Ireland",2008,2008,2,2,1,1,1,0,0,1
"1787","JV Harris ","Canada",2003,2003,6,6,1,1,1,0,0,1
"1788","RG Hart ","New Zealand",2002,2002,2,2,1,1,0,1,0,1
"1789","Hasan Jamil ","Pakistan",1977,1978,6,6,1,1,1,0,0,1
"1790","Hasan Raza ","Pakistan",1996,1999,16,15,1,1,1,0,0,1
"1791","TJ Heggelman ","Netherlands",2010,2011,5,5,1,1,1,0,0,1
"1792","O Henry ","South Africa",1992,1992,3,3,1,1,1,0,0,1
"1793","JG Heron ","Zimbabwe",1983,1983,6,6,1,1,1,0,0,1
"1794","PD Heyn ","Sri Lanka",1975,1975,2,2,1,1,1,0,0,1
"1795","AMJ Hilditch ","Australia",1979,1985,8,8,1,1,1,0,0,1
"1796","KC Hodsoll ","Bermuda",2007,2008,3,3,1,1,1,0,0,1
"1797","CK Hooper ","Canada",2007,2010,5,5,1,1,1,0,0,1
"1798","KA Hope ","West Indies",2017,2017,7,7,1,1,1,0,0,1
"1799","AG Hurst ","Australia",1975,1979,8,7,1,1,1,0,0,1
"1800","RO Hussain ","Scotland",2006,2010,8,7,1,1,1,0,0,1
"1801","KH Butt ","Hong Kong",2008,2008,2,2,1,1,1,0,0,1
"1802","DP Hyatt ","West Indies",2011,2011,9,9,1,1,1,0,0,1
"1803","Ibrahim Zadran ","Afghanistan",2019,2019,1,1,1,1,1,0,0,1
"1804","AP Igglesden ","England",1994,1994,4,4,1,1,1,0,0,1
"1805","Ijaz Ahmed jnr ","Pakistan",1997,1997,2,2,1,1,1,0,0,1
"1806","R Illingworth ","England",1971,1973,3,2,1,1,1,0,0,1
"1807","Imran Abbas ","Pakistan",2000,2000,2,2,1,1,1,0,0,1
"1808","MM Iqbal ","Scotland",2009,2014,13,13,1,1,1,0,0,1
"1809","Irfan Bhatti ","Pakistan",1993,1993,1,1,1,1,1,0,0,1
"1810","Izatullah Dawlatzai ","Afghanistan",2010,2015,5,5,1,1,1,0,0,1
"1811","Jahangir Alam ","Bangladesh",1997,1999,3,3,1,0,0,0,1,1
"1812","Jahangir Shah ","Bangladesh",1986,1990,5,5,1,1,1,0,0,1
"1813","Jalal-ud-Din ","Pakistan",1982,1983,8,7,1,1,1,0,0,1
"1814","Jamaluddin Ahmed ","Bangladesh",2003,2003,1,1,1,1,1,0,0,1
"1815","F Jansen ","Netherlands",1996,1996,2,2,1,1,1,0,0,1
"1816","MP Jarvis ","Zimbabwe",1987,1995,12,12,1,1,1,0,0,1
"1817","PW Jarvis ","England",1988,1993,16,16,1,1,1,0,0,1
"1818","Javed Qadeer ","Pakistan",1995,1995,1,1,1,1,0,1,0,1
"1819","SA Jayasinghe ","Sri Lanka",1979,1979,2,2,1,1,0,1,0,1
"1820","GSNFG Jayasuriya ","Sri Lanka",2015,2019,12,12,1,1,1,0,0,1
"1821","Jay Odedra ","Oman",2019,2020,3,3,1,1,1,0,0,1
"1822","S Jeganathan ","Sri Lanka",1983,1988,5,5,1,1,1,0,0,1
"1823","MR Johnson ","United States of America",2004,2004,2,2,1,1,0,1,0,1
"1824","MBS Jonkman ","Netherlands",2006,2010,16,16,1,1,1,0,0,1
"1825","MMA Jonkman ","Netherlands",2007,2010,4,4,1,1,1,0,0,1
"1826","DI Joyce ","Ireland",2006,2007,3,3,1,1,1,0,0,1
"1827","Jubair Hossain ","Bangladesh",2014,2015,3,3,1,1,1,0,0,1
"1828","Kabir Khan ","Pakistan",1994,2000,10,9,1,1,1,0,0,1
"1829","Kamran Shazad ","United Arab Emirates",2014,2015,4,4,1,1,1,0,0,1
"1830","TS Kamunhukamwe ","Zimbabwe",2018,2020,6,6,1,1,1,0,0,1
"1831","AR Kapoor ","India",1995,2000,17,17,1,1,1,0,0,1
"1832","M Karg ","Namibia",2003,2003,3,3,1,1,0,1,0,1
"1833","SHU Karnain ","Sri Lanka",1984,1990,19,19,1,1,1,0,0,1
"1834","S Kaul ","India",2018,2018,3,3,1,1,1,0,0,1
"1835","RJ Kennedy ","New Zealand",1996,1996,7,7,1,1,1,0,0,1
"1836","JC Kent ","South Africa",2002,2002,2,2,1,1,1,0,0,1
"1837","RB Kerr ","Australia",1985,1985,4,4,1,1,1,0,0,1
"1838","S Keshvani ","Canada",2009,2009,5,4,1,1,1,0,0,1
"1839","SP Khakurel ","Nepal",2018,2020,5,5,1,0,0,0,1,1
"1840","Khalid Latif ","Pakistan",2008,2010,5,5,1,1,1,0,0,1
"1841","Khurram Nawaz ","Oman",2019,2019,3,3,1,1,1,0,0,1
"1842","GE Kidd ","Ireland",2007,2008,6,5,1,1,1,0,0,1
"1843","J Kila ","Papau New Guinea",2018,2019,6,6,1,1,1,0,0,1
"1844","VJ Kingma ","Netherlands",2014,2019,3,3,1,1,1,0,0,1
"1845","JF Kloppenburg ","Netherlands",2002,2003,6,6,1,1,1,0,0,1
"1846","BL Kotze ","Namibia",2003,2003,5,5,1,1,1,0,0,1
"1847","GJP Kruger ","South Africa",2006,2006,3,3,1,1,1,0,0,1
"1848","CKB Kulasekara ","Sri Lanka",2011,2012,4,4,1,1,1,0,0,1
"1849","M Labuschagne ","Australia",2020,2020,7,7,1,1,1,0,0,1
"1850","JPR Lamsam ","Hong Kong",2004,2008,2,2,1,1,1,0,0,1
"1851","WM Lawry ","Australia",1971,1971,1,1,1,1,1,0,0,1
"1852","ML Lewis ","Australia",2005,2006,7,7,1,1,1,0,0,1
"1853","ACI Lock ","Zimbabwe",1996,1996,8,7,1,1,1,0,0,1
"1854","JL Louw ","Namibia",2003,2003,1,1,1,1,1,0,0,1
"1855","JD Love ","England",1981,1981,3,3,1,1,1,0,0,1
"1856","SW Lubbers ","Netherlands",1996,1996,4,4,1,1,1,0,0,1
"1857","MJ Lumb ","England",2014,2014,3,3,1,1,1,0,0,1
"1858","AS Luseno ","Kenya",2003,2010,10,10,1,1,1,0,0,1
"1859","MA Lynch ","England",1988,1988,3,3,1,1,1,0,0,1
"1860","RJ McCurdy ","Australia",1985,1985,11,11,1,1,1,0,0,1
"1861","PE McEwan ","New Zealand",1980,1985,17,17,1,1,1,0,0,1
"1862","AJ Mackay ","Zimbabwe",2001,2001,3,3,1,1,1,0,0,1
"1863","GD McKenzie ","Australia",1971,1971,1,1,1,1,1,0,0,1
"1864","DL Maddy ","England",1998,2000,8,8,1,1,1,0,0,1
"1865","W Madhevere ","Zimbabwe",2020,2020,3,3,1,1,1,0,0,1
"1866","Mafizur Rahman ","Bangladesh",1997,1997,4,4,1,1,1,0,0,1
"1867","KA Maharaj ","South Africa",2017,2020,7,7,1,1,1,0,0,1
"1868","Mahbubul Alam ","Bangladesh",2009,2009,5,5,1,1,1,0,0,1
"1869","SI Mahmood ","England",2004,2009,26,26,1,1,1,0,0,1
"1870","GT Main ","Scotland",2019,2019,1,1,1,1,1,0,0,1
"1871","DE Malcolm ","England",1990,1994,10,10,1,1,1,0,0,1
"1872","MF Malone ","Australia",1977,1982,10,10,1,1,1,0,0,1
"1873","Manzoor Akhtar ","Pakistan",1997,1998,7,7,1,1,1,0,0,1
"1874","PJ Martin ","England",1995,1998,20,20,1,1,1,0,0,1
"1875","RAL Massie ","Australia",1972,1972,3,3,1,1,1,0,0,1
"1876","EZ Matambanadzo ","Zimbabwe",1996,1997,7,7,1,1,1,0,0,1
"1877","Mazhar Hussain ","United Arab Emirates",1994,1996,7,7,1,1,1,0,0,1
"1878","JA McCollum ","Ireland",2019,2020,9,9,1,1,1,0,0,1
"1879","V Mehra ","United Arab Emirates",1994,1996,6,6,1,1,1,0,0,1
"1880","KP Meiyappan ","United Arab Emirates",2019,2020,4,4,1,1,1,0,0,1
"1881","KO Meth ","Zimbabwe",2006,2012,11,11,1,1,1,0,0,1
"1882","JP Millmow ","New Zealand",1990,1990,5,5,1,1,1,0,0,1
"1883","A Mithun ","India",2010,2011,5,5,1,1,1,0,0,1
"1884","Mohammad Boota ","United Arab Emirates",2018,2019,9,9,1,0,0,0,1,1
"1885","Mohammad Hasnain ","Pakistan",2019,2019,5,5,1,1,1,0,0,1
"1886","Mohammad Ishaq ","United Arab Emirates",1994,1996,5,5,1,1,1,0,0,1
"1887","Mohammad Salim ","Bangladesh",2003,2003,1,1,1,1,0,1,0,1
"1888","Mohammad Sharif ","Bangladesh",2001,2007,9,9,1,1,1,0,0,1
"1889","Mohammad Zahid ","Pakistan",1996,2002,11,11,1,1,1,0,0,1
"1890","D Mohammed ","West Indies",2006,2008,7,7,1,1,1,0,0,1
"1891","Mosharraf Hossain ","Bangladesh",2008,2016,5,5,1,1,1,0,0,1
"1892","TV Mufambisi ","Zimbabwe",2006,2007,6,6,1,1,0,1,0,1
"1893","SP Mukherjee ","India",1990,1991,3,3,1,1,1,0,0,1
"1894","J Mulder ","Ireland",2017,2017,4,4,1,1,1,0,0,1
"1895","CT Mumba ","Zimbabwe",2016,2020,5,5,1,1,1,0,0,1
"1896","N M'shangwe ","Zimbabwe",2011,2014,6,6,1,1,1,0,0,1
"1897","DT Mutendera ","Zimbabwe",1999,2001,9,9,1,1,1,0,0,1
"1898","G Mylvaganam ","United Arab Emirates",1996,1996,3,3,1,1,1,0,0,1
"1899","Naeemuddin Aslam ","United Arab Emirates",2004,2004,2,2,1,1,1,0,0,1
"1900","Naeem Ahmed ","Pakistan",1978,1978,1,1,1,1,1,0,0,1
"1901","Najeeb Amar ","Hong Kong",2004,2008,4,4,1,1,1,0,0,1
"1902","Naseem Khushi ","Oman",2020,2020,6,6,1,1,1,0,0,1
"1903","BP Nash ","West Indies",2008,2009,9,8,1,1,1,0,0,1
"1904","SV Nayak ","India",1981,1982,4,4,1,1,1,0,0,1
"1905","Nazimuddin ","Bangladesh",2008,2012,11,11,1,1,1,0,0,1
"1906","Neeyamur Rashid ","Bangladesh",1999,1999,2,2,1,1,1,0,0,1
"1907","A Neill ","Scotland",2019,2019,1,1,1,1,1,0,0,1
"1908","R Ngarava ","Zimbabwe",2017,2018,9,9,1,1,1,0,0,1
"1909","Noor-ul-Haq ","Afghanistan",2010,2010,2,2,1,1,1,0,0,1
"1910","MJ North ","Australia",2009,2009,2,2,1,1,1,0,0,1
"1911","GH O'Brien ","Bermuda",2006,2008,9,9,1,1,1,0,0,1
"1912","IE O'Brien ","New Zealand",2008,2009,10,10,1,1,1,0,0,1
"1913","NM Odhiambo ","Kenya",2010,2013,8,8,1,1,1,0,0,1
"1914","NV Ojha ","India",2010,2010,1,1,1,0,0,0,1,1
"1915","LN Oluoch ","Kenya",2011,2011,2,2,1,1,1,0,0,1
"1916","G Onions ","England",2009,2009,4,4,1,1,1,0,0,1
"1917","Pankaj Singh ","India",2010,2010,1,1,1,1,1,0,0,1
"1918","MHW Papps ","New Zealand",2004,2005,6,6,1,1,1,0,0,1
"1919","JS Paris ","Australia",2016,2016,2,2,1,1,1,0,0,1
"1920","NM Parker ","New Zealand",1976,1976,1,1,1,1,1,0,0,1
"1921","AK Patel ","India",1984,1985,8,7,1,1,1,0,0,1
"1922","BP Patel ","India",1974,1979,10,10,1,1,1,0,0,1
"1923","NK Patel ","United States of America",2019,2020,8,8,1,1,1,0,0,1
"1924","J Patraj ","Canada",2007,2007,2,2,1,1,1,0,0,1
"1925","SG Peall ","Zimbabwe",1992,1996,21,20,1,1,1,0,0,1
"1926","AJ Penn ","New Zealand",1997,2001,5,5,1,1,1,0,0,1
"1927","AK Perera ","Sri Lanka",2013,2019,6,6,1,1,1,0,0,1
"1928","PARP Perera ","Sri Lanka",2019,2019,2,2,1,1,1,0,0,1
"1929","V Permaul ","West Indies",2012,2017,7,7,1,1,1,0,0,1
"1930","AR Pitcher ","Bermuda",2006,2007,4,4,1,1,1,0,0,1
"1931","V Pollard ","New Zealand",1973,1974,3,3,1,1,1,0,0,1
"1932","RH Poonawala ","United Arab Emirates",1994,1994,2,2,1,1,1,0,0,1
"1933","GD Porter ","Australia",1979,1979,2,2,1,1,1,0,0,1
"1934","KTGD Prasad ","Sri Lanka",2006,2015,24,24,1,1,1,0,0,1
"1935","AG Puttick ","South Africa",2005,2005,1,1,1,1,1,0,0,1
"1936","Qadeer Ahmed ","United Arab Emirates",2015,2019,11,11,1,1,1,0,0,1
"1937","Rahat Ali ","Pakistan",2012,2016,14,14,1,1,1,0,0,1
"1938","P Raho ","Papau New Guinea",2014,2014,1,1,1,1,1,0,0,1
"1939","LN Rajbanshi ","Nepal",2019,2020,4,4,1,1,1,0,0,1
"1940","CAK Rajitha ","Sri Lanka",2018,2019,9,9,1,1,1,0,0,1
"1941","SK Ranasinghe ","Sri Lanka",1986,1986,4,4,1,1,1,0,0,1
"1942","D Ranatunga ","Sri Lanka",1990,1990,4,4,1,1,1,0,0,1
"1943","U Ranchod ","Zimbabwe",1992,1993,3,3,1,1,1,0,0,1
"1944","Raqibul Hasan ","Bangladesh",1986,1986,2,2,1,1,1,0,0,1
"1945","JB Reva ","Papau New Guinea",2016,2018,9,9,1,1,1,0,0,1
"1946","ACL Richards ","West Indies",2007,2007,1,1,1,1,1,0,0,1
"1947","MH Richardson ","New Zealand",2002,2002,4,4,1,1,1,0,0,1
"1948","Rizwan Ahmed ","Pakistan",2008,2008,1,1,1,1,1,0,0,1
"1949","ADG Roberts ","New Zealand",1976,1976,1,1,1,1,1,0,0,1
"1950","RJ Robinson ","Bermuda",2007,2009,3,3,1,1,1,0,0,1
"1951","LN Roche ","Zimbabwe",2018,2018,3,3,1,1,1,0,0,1
"1952","Rokhan Barakzai ","Afghanistan",2015,2015,1,1,1,1,1,0,0,1
"1953","LC Romero ","United States of America",2004,2004,2,2,1,1,1,0,0,1
"1954","BC Rose ","England",1977,1977,2,2,1,1,1,0,0,1
"1955","MW Rushmere ","South Africa",1992,1992,4,4,1,1,1,0,0,1
"1956","Saadat Ali ","Pakistan",1984,1984,8,8,1,1,1,0,0,1
"1957","Saeed-al-Saffar ","United Arab Emirates",1996,1996,1,1,1,1,1,0,0,1
"1958","Sajid Ali ","Pakistan",1984,1997,13,13,1,1,1,0,0,1
"1959","Saleem Altaf ","Pakistan",1973,1978,6,6,1,1,1,0,0,1
"1960","IDK Salisbury ","England",1993,1994,4,4,1,1,1,0,0,1
"1961","G Salmond ","Scotland",1999,1999,5,5,1,1,1,0,0,1
"1962","JA Samarasekera ","United Arab Emirates",1994,1996,7,7,1,1,1,0,0,1
"1963","S Samarawickrama ","Sri Lanka",2017,2019,7,7,1,1,1,0,0,1
"1964","Samiur Rahman ","Bangladesh",1986,1986,2,2,1,1,1,0,0,1
"1965","RG Samuels ","West Indies",1996,1997,8,8,1,1,1,0,0,1
"1966","KT Sandher ","Canada",2006,2007,15,15,1,1,1,0,0,1
"1967","BB Seebaran ","Canada",2003,2003,4,4,1,1,1,0,0,1
"1968","CS Serjeant ","Australia",1977,1978,3,3,1,1,1,0,0,1
"1969","RK Sethi ","East (and Central) Africa",1975,1975,3,3,1,1,1,0,0,1
"1970","Shadab Kabir ","Pakistan",1996,1996,3,3,1,1,1,0,0,1
"1971","Shafiq Ahmed ","Pakistan",1977,1978,3,3,1,1,1,0,0,1
"1972","KD Shah ","Hong Kong",2014,2018,10,10,1,1,1,0,0,1
"1973","Shahid Mahboob ","Pakistan",1982,1984,10,10,1,1,1,0,0,1
"1974","Shan Masood ","Pakistan",2019,2019,5,5,1,1,1,0,0,1
"1975","R Sharma ","Hong Kong",2004,2004,2,2,1,1,1,0,0,1
"1976","R Sharma ","India",2011,2012,4,4,1,1,1,0,0,1
"1977","B Shikongo ","Namibia",2020,2020,1,1,1,1,1,0,0,1
"1978","LR Shukla ","India",1999,1999,3,3,1,1,1,0,0,1
"1979","K Shuttleworth ","England",1971,1971,1,1,1,1,1,0,0,1
"1980","PM Siddle ","Australia",2009,2019,20,19,1,1,1,0,0,1
"1981","RW Sims ","Zimbabwe",2002,2003,3,3,1,1,1,0,0,1
"1982","L Sipamla ","South Africa",2020,2020,4,3,1,1,1,0,0,1
"1983","MA Small ","West Indies",1984,1984,2,2,1,1,1,0,0,1
"1984","MJ Smith ","England",1973,1974,5,5,1,1,1,0,0,1
"1985","NMK Smith ","England",1996,1996,7,7,1,1,1,0,0,1
"1986","JA Snow ","England",1971,1975,9,8,1,1,1,0,0,1
"1987","GS Sobers ","West Indies",1973,1973,1,1,1,1,1,0,0,1
"1988","Sohail Fazal ","Pakistan",1989,1989,2,2,1,1,1,0,0,1
"1989","Sompal Kami ","Nepal",2018,2019,6,6,1,1,1,0,0,1
"1990","D Soraine ","Canada",2006,2012,4,4,1,1,1,0,0,1
"1991","BB Sran ","India",2016,2016,6,6,1,1,1,0,0,1
"1992","L Sreekumar ","United Arab Emirates",2015,2016,4,4,1,1,1,0,0,1
"1993","S Sriram ","India",2000,2004,8,8,1,1,1,0,0,1
"1994","KR Stackpole ","Australia",1971,1974,6,6,1,1,1,0,0,1
"1995","JH Stander ","Scotland",2009,2012,5,5,1,1,1,0,0,1
"1996","B Stanlake ","Australia",2017,2019,7,7,1,1,1,0,0,1
"1997","LW Stokkers ","Netherlands",2008,2008,1,1,1,1,1,0,0,1
"1998","LW Stott ","New Zealand",1979,1979,1,1,1,1,1,0,0,1
"1999","CEL Stuart ","West Indies",2001,2001,5,5,1,1,1,0,0,1
"2000","ML Su'a ","New Zealand",1992,1995,12,12,1,1,1,0,0,1
"2001","R Sudhakar Rao ","India",1976,1976,1,1,1,1,1,0,0,1
"2002","Syed Maqsood ","United Arab Emirates",2004,2004,2,2,1,1,1,0,0,1
"2003","Taijul Islam ","Bangladesh",2014,2020,9,9,1,1,1,0,0,1
"2004","Talha Jubair ","Bangladesh",2002,2003,6,6,1,1,1,0,0,1
"2005","Tanbir Hayder ","Bangladesh",2016,2016,2,2,1,1,1,0,0,1
"2006","Tanvir Ahmed ","Pakistan",2011,2011,2,2,1,1,1,0,0,1
"2007","BR Taylor ","New Zealand",1973,1973,2,2,1,1,1,0,0,1
"2008","GJ Thompson ","Ireland",2008,2008,3,3,1,1,1,0,0,1
"2009","FJ Titmus ","England",1975,1975,2,2,1,1,1,0,0,1
"2010","RW Tolchard ","England",1979,1979,1,1,1,1,0,1,0,1
"2011","CP Tremain ","Australia",2016,2016,4,4,1,1,1,0,0,1
"2012","JO Troughton ","England",2003,2003,6,5,1,1,1,0,0,1
"2013","AJ Tudor ","England",2002,2002,3,3,1,1,1,0,0,1
"2014","S Tyagi ","India",2009,2010,4,4,1,1,1,0,0,1
"2015","AJ Tye ","Australia",2018,2018,7,7,1,1,1,0,0,1
"2016","SD Udal ","England",1994,2005,11,11,1,1,1,0,0,1
"2017","Umair Ali ","United Arab Emirates",2015,2015,2,2,1,1,1,0,0,1
"2018","Usman Salahuddin ","Pakistan",2011,2011,2,2,1,1,1,0,0,1
"2019","JN Valentine ","Canada",1979,1979,3,3,1,1,1,0,0,1
"2020","A van der Merwe ","Ireland",2010,2011,9,9,1,1,1,0,0,1
"2021","VB van Jaarsveld ","South Africa",2009,2009,2,2,1,1,1,0,0,1
"2022","S Vesawkar ","Nepal",2018,2020,2,2,1,1,1,0,0,1
"2023","TP Visee ","Netherlands",2019,2019,2,2,1,1,1,0,0,1
"2024","AL Wadekar ","India",1974,1974,2,2,1,1,1,0,0,1
"2025","I Wardlaw ","Scotland",2013,2015,22,21,1,1,1,0,0,1
"2026","Washington Sundar ","India",2017,2017,1,1,1,1,1,0,0,1
"2027","SR Welsh ","Canada",2006,2008,3,3,1,1,1,0,0,1
"2028","BA Westdijk ","Netherlands",2011,2011,4,4,1,1,1,0,0,1
"2029","AG Wharf ","England",2004,2005,13,13,1,1,1,0,0,1
"2030","BM Wheeler ","New Zealand",2015,2015,6,6,1,1,1,0,0,1
"2031","JJ Whitaker ","England",1987,1987,2,2,1,1,1,0,0,1
"2032","DJ White ","New Zealand",1990,1990,3,3,1,1,1,0,0,1
"2033","P Wilson ","Australia",1997,1998,11,11,1,1,1,0,0,1
"2034","WA Wisneski ","New Zealand",2000,2000,3,3,1,1,1,0,0,1
"2035","DJ Worrall ","Australia",2016,2016,3,3,1,1,1,0,0,1
"2036","CM Wright ","Scotland",2006,2009,20,20,1,1,1,0,0,1
"2037","M Yachad ","South Africa",1991,1991,1,1,1,1,1,0,0,1
"2038","J Yadav ","India",2016,2016,1,1,1,1,1,0,0,1
"2039","NS Yadav ","India",1986,1987,7,7,1,1,1,0,0,1
"2040","HN Ya France ","Namibia",2019,2020,7,7,1,1,1,0,0,1
"2041","B Yardley ","Australia",1978,1983,7,5,1,1,1,0,0,1
"2042","Younis Ahmed ","Pakistan",1987,1987,2,2,1,1,1,0,0,1
"2043","Zafar Iqbal ","Pakistan",1995,1995,8,8,1,1,1,0,0,1
"2044","Zahid Hussain ","Canada",2011,2011,2,2,1,1,1,0,0,1
"2045","Sultan Zarawani ","United Arab Emirates",1994,1996,7,7,1,1,1,0,0,1
"2046","AK Zesers ","Australia",1987,1987,2,2,1,1,1,0,0,1
"2047","C Zhuwao ","Zimbabwe",2008,2018,9,9,1,1,1,0,0,1
"2048","K Zondo ","South Africa",2018,2018,5,5,1,1,1,0,0,1
"2049","Zulfiqar Ali ","East (and Central) Africa",1975,1975,3,3,1,1,1,0,0,1
"2050","ME Sanuth ","Oman",2020,2020,3,3,0,0,0,0,0,0
"2051","Aamer Hanif ","Pakistan",1993,1995,5,5,0,0,0,0,0,0
"2052","Aamer Nazir ","Pakistan",1993,1995,9,9,0,0,0,0,0,0
"2053","Aamer Yamin ","Pakistan",2015,2018,4,4,0,0,0,0,0,0
"2054","SA Abbott ","Australia",2014,2014,1,1,0,0,0,0,0,0
"2055","Abdul Rehman ","United Arab Emirates",2004,2004,1,1,0,0,0,0,0,0
"2056","S Abid Ali ","India",1974,1975,5,5,0,0,0,0,0,0
"2057","Abu Jayed ","Bangladesh",2019,2019,2,2,0,0,0,0,0,0
"2058","Afif Hossain ","Bangladesh",2020,2020,1,1,0,0,0,0,0,0
"2059","FS Ahangama ","Sri Lanka",1985,1985,1,1,0,0,0,0,0,0
"2060","Ahmed Kamal ","Bangladesh",1999,1999,1,1,0,0,0,0,0,0
"2061","Ahmed Shah ","Afghanistan",2009,2009,1,1,0,0,0,0,0,0
"2062","KS Airee ","Nepal",2020,2020,1,1,0,0,0,0,0,0
"2063","Akhtar Sarfraz ","Pakistan",1997,1998,4,4,0,0,0,0,0,0
"2064","Alawi Shukri ","United Arab Emirates",2008,2008,1,1,0,0,0,0,0,0
"2065","GW Aldridge ","New Zealand",2011,2011,2,2,0,0,0,0,0,0
"2066","RP Alexander ","United States of America",2004,2004,2,2,0,0,0,0,0,0
"2067","Ali Asad ","United Arab Emirates",2004,2004,2,2,0,0,0,0,0,0
"2068","Ali Khan ","United States of America",2019,2019,1,1,0,0,0,0,0,0
"2069","KN Amalean ","Sri Lanka",1986,1988,8,8,0,0,0,0,0,0
"2070","Aman Ali ","United Arab Emirates",2008,2008,1,1,0,0,0,0,0,0
"2071","Aminul Islam jnr ","Bangladesh",1999,1999,1,1,0,0,0,0,0,0
"2072","J Angel ","Australia",1994,1995,3,3,0,0,0,0,0,0
"2073","Anisur Rahman ","Bangladesh",1995,1998,2,2,0,0,0,0,0,0
"2074","ZS Ansari ","England",2015,2015,1,1,0,0,0,0,0,0
"2075","HAG Anthony ","West Indies",1995,1995,3,3,0,0,0,0,0,0
"2076","Anwar Hossain Monir ","Bangladesh",2002,2002,1,1,0,0,0,0,0,0
"2077","Anwar Hossain ","Bangladesh",2002,2002,1,1,0,0,0,0,0,0
"2078","GJAF Aponso ","Netherlands",1996,1996,5,5,0,0,0,0,0,0
"2079","MA Aponso ","Sri Lanka",2016,2018,9,9,0,0,0,0,0,0
"2080","Ariful Haque ","Bangladesh",2018,2018,1,1,0,0,0,0,0,0
"2081","Arshad Pervez ","Pakistan",1978,1978,2,2,0,0,0,0,0,0
"2082","B Arun ","India",1986,1987,4,4,0,0,0,0,0,0
"2083","Asad Ali ","Pakistan",2013,2013,4,4,0,0,0,0,0,0
"2084","Asghar Ali ","United Arab Emirates",2004,2004,2,2,0,0,0,0,0,0
"2085","Ashfaq Ahmed ","Pakistan",1994,1994,3,3,0,0,0,0,0,0
"2086","Asif Iqbal (1) ","United Arab Emirates",2015,2015,1,1,0,0,0,0,0,0
"2087","Asif Mahmood ","Pakistan",1998,1998,2,2,0,0,0,0,0,0
"2088","Asim Butt ","Scotland",1999,1999,5,5,0,0,0,0,0,0
"2089","Asim Saeed ","United Arab Emirates",2004,2004,2,2,0,0,0,0,0,0
"2090","SK Atai ","Papau New Guinea",2019,2019,2,2,0,0,0,0,0,0
"2091","Ata-ur-Rehman ","Pakistan",1992,1996,30,30,0,0,0,0,0,0
"2092","ID Austin ","England",1998,1999,9,9,0,0,0,0,0,0
"2093","RA Austin ","West Indies",1978,1978,1,1,0,0,0,0,0,0
"2094","Azmat Rana ","Pakistan",1978,1978,2,2,0,0,0,0,0,0
"2095","MD Bailey ","New Zealand",1998,1998,1,1,0,0,0,0,0,0
"2096","PJ Bakker ","Netherlands",1996,1996,5,5,0,0,0,0,0,0
"2097","S Baksh ","Canada",1979,1979,1,1,0,0,0,0,0,0
"2098","KMC Bandara ","Sri Lanka",2016,2016,1,1,0,0,0,0,0,0
"2099","MRCN Bandaratilleke ","Sri Lanka",1998,1998,3,3,0,0,0,0,0,0
"2100","OAC Banks ","West Indies",2003,2005,5,5,0,0,0,0,0,0
"2101","T Banton ","England",2020,2020,3,3,0,0,0,0,0,0
"2102","KJ Barnett ","England",1988,1988,1,1,0,0,0,0,0,0
"2103","DM Basden ","Bermuda",2007,2007,2,2,0,0,0,0,0,0
"2104","GR Beard ","Australia",1981,1981,2,2,0,0,0,0,0,0
"2105","RR Beaton ","West Indies",2017,2017,2,2,0,0,0,0,0,0
"2106","JE Benjamin ","England",1994,1995,2,2,0,0,0,0,0,0
"2107","MR Benson ","England",1986,1986,1,1,0,0,0,0,0,0
"2108","A Bhandari ","India",2000,2004,2,2,0,0,0,0,0,0
"2109","LS Bhandari ","Nepal",2018,2018,1,1,0,0,0,0,0,0
"2110","M Bhanuka ","Sri Lanka",2019,2019,1,1,0,0,0,0,0,0
"2111","S Bhari ","Nepal",2020,2020,4,4,0,0,0,0,0,0
"2112","Bhupinder Singh snr ","India",1994,1994,2,2,0,0,0,0,0,0
"2113","MI Black ","West Indies",2001,2001,5,5,0,0,0,0,0,0
"2114","DL Blake ","United States of America",2004,2004,1,1,0,0,0,0,0,0
"2115","G Blakeney ","Bermuda",2009,2009,2,2,0,0,0,0,0,0
"2116","A Bohara ","Nepal",2020,2020,2,2,0,0,0,0,0,0
"2117","SG Borthwick ","England",2011,2011,2,2,0,0,0,0,0,0
"2118","T Bosch ","South Africa",1992,1992,2,2,0,0,0,0,0,0
"2119","GK Bose ","India",1974,1974,1,1,0,0,0,0,0,0
"2120","KD Boyce ","West Indies",1973,1975,8,8,0,0,0,0,0,0
"2121","BP Bracewell ","New Zealand",1978,1978,1,1,0,0,0,0,0,0
"2122","GA Briant ","Zimbabwe",1993,1993,5,5,0,0,0,0,0,0
"2123","DR Briggs ","England",2012,2012,1,1,0,0,0,0,0,0
"2124","SA Britton ","Ireland",2009,2009,1,1,0,0,0,0,0,0
"2125","D Brown ","West Indies",2001,2002,3,3,0,0,0,0,0,0
"2126","BS Browne ","West Indies",1994,1994,4,4,0,0,0,0,0,0
"2127","GK Bruk-Jackson ","Zimbabwe",1993,1993,1,1,0,0,0,0,0,0
"2128","DE Budge ","Scotland",2018,2019,3,3,0,0,0,0,0,0
"2129","AJ Burger ","Namibia",2003,2003,6,6,0,0,0,0,0,0
"2130","AR Butcher ","England",1980,1980,1,1,0,0,0,0,0,0
"2131","RO Butcher ","England",1980,1981,3,3,0,0,0,0,0,0
"2132","DK Butler ","West Indies",2005,2006,5,5,0,0,0,0,0,0
"2133","RG Callender ","Canada",1979,1979,2,2,0,0,0,0,0,0
"2134","JD Campbell ","West Indies",2019,2019,6,5,0,0,0,0,0,0
"2135","PE Cantrell ","Netherlands",1996,1996,5,5,0,0,0,0,0,0
"2136","PH Carlson ","Australia",1979,1979,4,3,0,0,0,0,0,0
"2137","NM Carter ","Scotland",2013,2013,3,3,0,0,0,0,0,0
"2138","DL Chahar ","India",2018,2019,3,3,0,0,0,0,0,0
"2139","SJ Chalmers ","Scotland",2009,2009,2,2,0,0,0,0,0,0
"2140","BS Chandrasekhar ","India",1976,1976,1,1,0,0,0,0,0,0
"2141","VB Chandrasekhar ","India",1988,1990,7,7,0,0,0,0,0,0
"2142","CJD Chappell ","Canada",1979,1979,3,3,0,0,0,0,0,0
"2143","G Chapple ","England",2006,2006,1,1,0,0,0,0,0,0
"2144","M Cheruparambil ","Hong Kong",2004,2004,2,2,0,0,0,0,0,0
"2145","MT Chinouya ","Zimbabwe",2013,2013,2,2,0,0,0,0,0,0
"2146","K Christie ","Hong Kong",2016,2016,1,1,0,0,0,0,0,0
"2147","WM Clark ","Australia",1978,1978,2,2,0,0,0,0,0,0
"2148","A Codrington ","Canada",2003,2007,9,9,0,0,0,0,0,0
"2149","DJ Colley ","Australia",1972,1972,1,1,0,0,0,0,0,0
"2150","BE Congdon ","New Zealand",1973,1978,11,11,0,0,0,0,0,0
"2151","AN Connolly ","Australia",1971,1971,1,1,0,0,0,0,0,0
"2152","GA Cope ","England",1977,1978,2,2,0,0,0,0,0,0
"2153","MJ Cosgrove ","Australia",2006,2006,3,3,0,0,0,0,0,0
"2154","CS Cowdrey ","England",1985,1985,3,3,0,0,0,0,0,0
"2155","MC Cowdrey ","England",1971,1971,1,1,0,0,0,0,0,0
"2156","RT Crandon ","West Indies",2009,2009,1,1,0,0,0,0,0,0
"2157","FS Crockwell ","Bermuda",2009,2009,2,2,0,0,0,0,0,0
"2158","SM Curran ","England",2018,2020,4,4,0,0,0,0,0,0
"2159","SS Das ","India",2001,2002,4,4,0,0,0,0,0,0
"2160","NA David ","India",1997,1997,4,4,0,0,0,0,0,0
"2161","RR David ","Canada",2008,2010,4,4,0,0,0,0,0,0
"2162","H Davids ","South Africa",2013,2013,2,1,0,0,0,0,0,0
"2163","SG Davies ","Zimbabwe",1996,1996,4,4,0,0,0,0,0,0
"2164","IC Davis ","Australia",1974,1977,3,3,0,0,0,0,0,0
"2165","Dawlat Ahmadzai ","Afghanistan",2009,2010,3,3,0,0,0,0,0,0
"2166","JJ Dawood ","Canada",2009,2010,2,1,0,0,0,0,0,0
"2167","LA Dawson ","England",2016,2018,3,2,0,0,0,0,0,0
"2168","NA de Groot ","Canada",2003,2003,6,6,0,0,0,0,0,0
"2169","M de Lange ","South Africa",2012,2016,4,4,0,0,0,0,0,0
"2170","GJ Delany ","Ireland",2020,2020,2,2,0,0,0,0,0,0
"2171","FA Dennis ","Canada",1979,1979,3,3,0,0,0,0,0,0
"2172","GN de Silva ","Sri Lanka",1983,1985,4,4,0,0,0,0,0,0
"2173","JI de Villiers ","Namibia",2020,2020,2,2,0,0,0,0,0,0
"2174","P Dharmani ","India",1996,1996,1,1,0,0,0,0,0,0
"2175","R Dhawan ","India",2016,2016,3,3,0,0,0,0,0,0
"2176","HS Dhillon ","Canada",2006,2006,2,2,0,0,0,0,0,0
"2177","WP Diepeveen ","Netherlands",2011,2011,1,1,0,0,0,0,0,0
"2178","Dolar Mahmud ","Bangladesh",2008,2009,7,7,0,0,0,0,0,0
"2179","BR Dorey ","Australia",2006,2006,4,4,0,0,0,0,0,0
"2180","CRM Douglas ","Bermuda",2008,2008,2,2,0,0,0,0,0,0
"2181","SO Dowrich ","West Indies",2019,2019,1,1,0,0,0,0,0,0
"2182","S Dube ","India",2019,2019,1,1,0,0,0,0,0,0
"2183","BM Duckett ","England",2016,2016,3,3,0,0,0,0,0,0
"2184","DM Dupavillon ","South Africa",2020,2020,1,1,0,0,0,0,0,0
"2185","N Dutta ","Canada",2013,2013,1,1,0,0,0,0,0,0
"2186","PS Eaglestone ","Ireland",2008,2008,1,1,0,0,0,0,0,0
"2187","JH Edrich ","England",1971,1975,7,7,0,0,0,0,0,0
"2188","R Edwards ","Australia",1972,1975,9,9,0,0,0,0,0,0
"2189","WJ Edwards ","Australia",1975,1975,1,1,0,0,0,0,0,0
"2190","Ehsanul Haque ","Bangladesh",2002,2003,6,6,0,0,0,0,0,0
"2191","Ehsan Adil ","Pakistan",2013,2015,6,6,0,0,0,0,0,0
"2192","Elias Sunny ","Bangladesh",2011,2012,4,4,0,0,0,0,0,0
"2193","MTG Elliott ","Australia",1997,1997,1,1,0,0,0,0,0,0
"2194","Fahad Alhashmi ","United Arab Emirates",2008,2015,5,5,0,0,0,0,0,0
"2195","Fahad Nawaz ","United Arab Emirates",2019,2019,2,2,0,0,0,0,0,0
"2196","Faisal Athar ","Pakistan",2003,2003,1,1,0,0,0,0,0,0
"2197","Fawad Ahmed ","Australia",2013,2013,3,3,0,0,0,0,0,0
"2198","Fayyaz Ahmed ","United Arab Emirates",2014,2016,3,3,0,0,0,0,0,0
"2199","FY Fazal ","India",2016,2016,1,1,0,0,0,0,0,0
"2200","Fazl-e-Akbar ","Pakistan",1998,2001,2,2,0,0,0,0,0,0
"2201","N Fernandes ","United Arab Emirates",2008,2008,1,1,0,0,0,0,0,0
"2202","AM Fernando ","Sri Lanka",2017,2017,1,1,0,0,0,0,0,0
"2203","ER Fernando ","Sri Lanka",1975,1975,3,3,0,0,0,0,0,0
"2204","ERNS Fernando ","Sri Lanka",1983,1983,7,7,0,0,0,0,0,0
"2205","MVT Fernando ","Sri Lanka",2017,2019,8,8,0,0,0,0,0,0
"2206","TL Fernando ","Sri Lanka",1989,1989,1,1,0,0,0,0,0,0
"2207","UNK Fernando ","Sri Lanka",1994,1994,2,2,0,0,0,0,0,0
"2208","R Flannigan ","Scotland",2010,2010,1,1,0,0,0,0,0,0
"2209","DAG Fletcher ","Zimbabwe",1983,1983,6,6,0,0,0,0,0,0
"2210","MLC Foster ","West Indies",1973,1973,2,2,0,0,0,0,0,0
"2211","TJ Franklin ","New Zealand",1983,1988,3,3,0,0,0,0,0,0
"2212","Frasat Ali ","East (and Central) Africa",1975,1975,3,3,0,0,0,0,0,0
"2213","IS Gallage ","Sri Lanka",1999,2001,3,3,0,0,0,0,0,0
"2214","DJ Gandhi ","India",1999,2000,3,3,0,0,0,0,0,0
"2215","D Ganesh ","India",1997,1997,1,1,0,0,0,0,0,0
"2216","LV Garrick ","West Indies",2001,2001,3,3,0,0,0,0,0,0
"2217","WT Gavera ","Papau New Guinea",2014,2017,4,4,0,0,0,0,0,0
"2218","RS Ghai ","India",1984,1986,6,6,0,0,0,0,0,0
"2219","Gholam Nousher ","Bangladesh",1986,1990,9,9,0,0,0,0,0,0
"2220","Ghulam Ali ","Pakistan",1993,1995,3,3,0,0,0,0,0,0
"2221","T Gibbons ","Bermuda",2006,2006,2,2,0,0,0,0,0,0
"2222","LR Gibbs ","West Indies",1973,1975,3,3,0,0,0,0,0,0
"2223","PG Gillespie ","Ireland",2006,2007,5,5,0,0,0,0,0,0
"2224","Golam Faruq ","Bangladesh",1986,1990,5,5,0,0,0,0,0,0
"2225","MS Gony ","India",2008,2008,2,2,0,0,0,0,0,0
"2226","Y Goonasekera ","Sri Lanka",1983,1983,3,3,0,0,0,0,0,0
"2227","JOA Gordon ","Canada",2012,2014,5,5,0,0,0,0,0,0
"2228","EL Gouka ","Netherlands",1996,1996,3,3,0,0,0,0,0,0
"2229","VD Grandia ","Netherlands",2002,2002,1,1,0,0,0,0,0,0
"2230","AE Greenidge ","West Indies",1978,1978,1,1,0,0,0,0,0,0
"2231","RD Gudhka ","Kenya",2011,2011,2,2,0,0,0,0,0,0
"2232","FRMD Gunatilleke ","Sri Lanka",1979,1979,1,1,0,0,0,0,0,0
"2233","AAW Gunawardena ","Sri Lanka",1994,1994,1,1,0,0,0,0,0,0
"2234","SK Gupta ","Kenya",1996,2001,10,10,0,0,0,0,0,0
"2235","Gurdeep Singh ","Kenya",2013,2013,1,1,0,0,0,0,0,0
"2236","Haafiz Shahid ","Pakistan",1988,1988,3,3,0,0,0,0,0,0
"2237","BG Hadlee ","New Zealand",1975,1975,2,2,0,0,0,0,0,0
"2238","OJ Hairs ","Scotland",2010,2010,5,5,0,0,0,0,0,0
"2239","JD Hall ","Ireland",2010,2010,3,3,0,0,0,0,0,0
"2240","LJ Hamilton ","New Zealand",2005,2005,2,2,0,0,0,0,0,0
"2241","JR Hammond ","Australia",1972,1972,1,1,0,0,0,0,0,0
"2242","JH Hampshire ","England",1971,1972,3,3,0,0,0,0,0,0
"2243","Hamza Tahir ","Scotland",2019,2019,6,6,0,0,0,0,0,0
"2244","Harilal Shah ","East (and Central) Africa",1975,1975,3,3,0,0,0,0,0,0
"2245","RT Hart ","New Zealand",1985,1985,1,1,0,0,0,0,0,0
"2246","Harunur Rashid ","Bangladesh",1988,1988,2,2,0,0,0,0,0,0
"2247","SM Harwood ","Australia",2009,2009,1,1,0,0,0,0,0,0
"2248","MJ Haslam ","New Zealand",1992,1992,1,1,0,0,0,0,0,0
"2249","Hasti Gul ","Afghanistan",2009,2009,2,2,0,0,0,0,0,0
"2250","FC Hayes ","England",1973,1975,6,5,0,0,0,0,0,0
"2251","RL Hayes ","New Zealand",1995,1995,1,1,0,0,0,0,0,0
"2252","RGA Headley ","West Indies",1973,1973,1,1,0,0,0,0,0,0
"2253","SD Heazlett ","Australia",2017,2017,1,1,0,0,0,0,0,0
"2254","R Hekure ","Papau New Guinea",2019,2019,1,1,0,0,0,0,0,0
"2255","CW Henderson ","South Africa",2001,2001,4,4,0,0,0,0,0,0
"2256","CC Henry ","Canada",1979,1979,2,2,0,0,0,0,0,0
"2257","H Hiri ","Papau New Guinea",2016,2019,7,7,0,0,0,0,0,0
"2258","VR Hogg ","Zimbabwe",1983,1983,2,2,0,0,0,0,0,0
"2259","RG Holland ","Australia",1985,1985,2,2,0,0,0,0,0,0
"2260","DAW Hollis ","Bermuda",2008,2008,1,1,0,0,0,0,0,0
"2261","PA Horne ","New Zealand",1987,1987,4,4,0,0,0,0,0,0
"2262","Hussain Talat ","Pakistan",2019,2019,1,1,0,0,0,0,0,0
"2263","Ilyas Gull ","Hong Kong",2004,2004,2,2,0,0,0,0,0,0
"2264","Intikhab Alam ","Pakistan",1973,1976,4,4,0,0,0,0,0,0
"2265","Iqbal Sikander ","Pakistan",1992,1992,4,4,0,0,0,0,0,0
"2266","Irfan Fazil ","Pakistan",2000,2000,1,1,0,0,0,0,0,0
"2267","Irfan Sajid ","United Arab Emirates",2014,2014,1,1,0,0,0,0,0,0
"2268","Ishtiaq Muhammad ","Hong Kong",2016,2016,1,1,0,0,0,0,0,0
"2269","W Jaffer ","India",2006,2006,2,2,0,0,0,0,0,0
"2270","Jahangir Alam Talukdar ","Bangladesh",1990,1990,2,2,0,0,0,0,0,0
"2271","JA Jameson ","England",1973,1975,3,3,0,0,0,0,0,0
"2272","Jasdeep Singh ","United States of America",2019,2019,4,4,0,0,0,0,0,0
"2273","Jawahir Shah ","East (and Central) Africa",1975,1975,3,3,0,0,0,0,0,0
"2274","PS Jayaprakashdaran ","Sri Lanka",2005,2005,1,1,0,0,0,0,0,0
"2275","RSA Jayasekera ","Sri Lanka",1982,1982,2,2,0,0,0,0,0,0
"2276","NGRP Jayasuriya ","Sri Lanka",2018,2018,2,2,0,0,0,0,0,0
"2277","TJ Jenner ","Australia",1975,1975,1,1,0,0,0,0,0,0
"2278","KCB Jeremy ","West Indies",2000,2001,6,6,0,0,0,0,0,0
"2279","K Jethi ","Canada",2008,2008,3,3,0,0,0,0,0,0
"2280","HR Johnson ","United States of America",2004,2004,2,2,0,0,0,0,0,0
"2281","RL Johnson ","England",2003,2003,10,9,0,0,0,0,0,0
"2282","RA Jones ","New Zealand",2003,2003,5,5,0,0,0,0,0,0
"2283","SP Jones ","England",2004,2005,8,8,0,0,0,0,0,0
"2284","C Jonker ","South Africa",2018,2018,2,2,0,0,0,0,0,0
"2285","S Jora ","Nepal",2019,2019,1,1,0,0,0,0,0,0
"2286","D Joseph ","Canada",2003,2003,4,4,0,0,0,0,0,0
"2287","Junaid Siddique ","United Arab Emirates",2019,2020,6,6,0,0,0,0,0,0
"2288","Junaid Zia ","Pakistan",2003,2003,4,4,0,0,0,0,0,0
"2289","R Kaia ","Zimbabwe",2015,2015,1,1,0,0,0,0,0,0
"2290","AV Kale ","India",2003,2003,1,1,0,0,0,0,0,0
"2291","LWS Kaluperuma ","Sri Lanka",1975,1982,4,4,0,0,0,0,0,0
"2292","Kamran Hussain ","Pakistan",2008,2008,2,2,0,0,0,0,0,0
"2293","K Kamyuka ","Canada",2013,2013,2,2,0,0,0,0,0,0
"2294","AL Kandappah ","Canada",2007,2007,2,2,0,0,0,0,0,0
"2295","Karan KC ","Nepal",2018,2020,9,9,0,0,0,0,0,0
"2296","Karim Janat ","Afghanistan",2017,2017,1,1,0,0,0,0,0,0
"2297","Kashif Raza ","Pakistan",2001,2001,1,1,0,0,0,0,0,0
"2298","F Kasteni ","Zimbabwe",2007,2007,3,3,0,0,0,0,0,0
"2299","E Katchay ","Canada",2008,2009,5,5,0,0,0,0,0,0
"2300","PHT Kaushal ","Sri Lanka",2015,2015,1,1,0,0,0,0,0,0
"2301","RWT Key ","England",2003,2004,5,5,0,0,0,0,0,0
"2302","Khalid Khan ","Hong Kong",2004,2004,2,2,0,0,0,0,0,0
"2303","Khaliq Dad ","Afghanistan",2009,2010,6,6,0,0,0,0,0,0
"2304","GK Khoda ","India",1998,1998,2,2,0,0,0,0,0,0
"2305","JP Kotze ","Namibia",2019,2020,8,8,0,0,0,0,0,0
"2306","CK Kruger ","Hong Kong",2008,2008,2,2,0,0,0,0,0,0
"2307","SC Kuggeleijn ","New Zealand",2017,2017,2,2,0,0,0,0,0,0
"2308","Kushal Malla ","Nepal",2020,2020,3,3,0,0,0,0,0,0
"2309","MKGCP Lakshitha ","Sri Lanka",2002,2003,7,7,0,0,0,0,0,0
"2310","AV Lalcheta ","Oman",2019,2019,2,2,0,0,0,0,0,0
"2311","SB Lama ","Hong Kong",2004,2004,1,1,0,0,0,0,0,0
"2312","GA Lamb ","Zimbabwe",2010,2011,15,15,0,0,0,0,0,0
"2313","CB Lambert (USA/WI)",NA,1990,2004,12,12,0,0,0,0,0,0
"2314","TJ Laughlin ","Australia",1978,1979,6,6,0,0,0,0,0,0
"2315","DV Lawrence ","England",1991,1991,1,1,0,0,0,0,0,0
"2316","JJC Lawson ","West Indies",2001,2005,13,12,0,0,0,0,0,0
"2317","J Lewis ","England",2005,2007,13,13,0,0,0,0,0,0
"2318","Liaqat Ali ","Pakistan",1977,1978,3,3,0,0,0,0,0,0
"2319","GFJ Liebenberg ","South Africa",1995,1998,4,4,0,0,0,0,0,0
"2320","JB Little ","Ireland",2019,2019,4,4,0,0,0,0,0,0
"2321","TA Lloyd ","England",1984,1984,3,3,0,0,0,0,0,0
"2322","CH Lonsdale ","Bermuda",2007,2007,1,1,0,0,0,0,0,0
"2323","AGR Loudon ","England",2006,2006,1,1,0,0,0,0,0,0
"2324","J Louw ","South Africa",2008,2008,3,3,0,0,0,0,0,0
"2325","MB Loye ","England",2007,2007,7,7,0,0,0,0,0,0
"2326","BW Luckhurst ","England",1975,1975,3,3,0,0,0,0,0,0
"2327","C McAuslan ","Hong Kong",2017,2017,2,2,0,0,0,0,0,0
"2328","OC McCoy ","West Indies",2018,2018,2,2,0,0,0,0,0,0
"2329","JA Maclean ","Australia",1979,1979,2,1,0,0,0,0,0,0
"2330","H McLeod ","East (and Central) Africa",1975,1975,2,2,0,0,0,0,0,0
"2331","NJ MacRae ","Scotland",2006,2006,2,2,0,0,0,0,0,0
"2332","DSK Madushanka ","Sri Lanka",2018,2018,1,1,0,0,0,0,0,0
"2333","LD Madushanka ","Sri Lanka",2017,2017,4,4,0,0,0,0,0,0
"2334","Mahbubur Rahman ","Bangladesh",1999,1999,1,1,0,0,0,0,0,0
"2335","S Mahmood ","England",2020,2020,1,1,0,0,0,0,0,0
"2336","Mahmood Hamid ","Pakistan",1995,1995,1,1,0,0,0,0,0,0
"2337","DJ Malan ","England",2019,2019,1,1,0,0,0,0,0,0
"2338","AV Mankad ","India",1974,1974,1,1,0,0,0,0,0,0
"2339","Mansoor Amjad ","Pakistan",2008,2008,1,1,0,0,0,0,0,0
"2340","Mansoor Rana ","Pakistan",1990,1990,2,2,0,0,0,0,0,0
"2341","Maqsood Rana ","Pakistan",1990,1990,1,1,0,0,0,0,0,0
"2342","CA Marshall ","Canada",1979,1979,2,2,0,0,0,0,0,0
"2343","JAH Marshall ","New Zealand",2005,2008,10,10,0,0,0,0,0,0
"2344","GC Martin ","Zimbabwe",1994,1995,5,5,0,0,0,0,0,0
"2345","Masood Iqbal ","Pakistan",1984,1984,1,1,0,0,0,0,0,0
"2346","SJ Massiah ","United States of America",2004,2004,2,2,0,0,0,0,0,0
"2347","PS Masvaure ","Zimbabwe",2018,2018,2,2,0,0,0,0,0,0
"2348","AW Mathieson ","New Zealand",2015,2015,1,1,0,0,0,0,0,0
"2349","BM Mauricette ","Canada",1979,1979,3,3,0,0,0,0,0,0
"2350","DES Maxwell ","Canada",2006,2007,10,10,0,0,0,0,0,0
"2351","Mazharul Haque ","Bangladesh",2002,2002,1,1,0,0,0,0,0,0
"2352","GJ McCarter ","Ireland",2014,2014,1,1,0,0,0,0,0,0
"2353","SC Meaker ","England",2011,2011,2,2,0,0,0,0,0,0
"2354","Mehmood Quaraishy ","East (and Central) Africa",1975,1975,3,3,0,0,0,0,0,0
"2355","PS Mehta ","East (and Central) Africa",1975,1975,1,1,0,0,0,0,0,0
"2356","MA Meman ","Zimbabwe",1987,1987,1,1,0,0,0,0,0,0
"2357","PHKD Mendis ","Sri Lanka",2019,2019,2,2,0,0,0,0,0,0
"2358","JM Mennie ","Australia",2016,2016,2,2,0,0,0,0,0,0
"2359","PL Mhambrey ","India",1996,1998,3,3,0,0,0,0,0,0
"2360","Mohammad Abbas ","Pakistan",2019,2019,3,3,0,0,0,0,0,0
"2361","Mohammad Aslam ","United Arab Emirates",1996,1996,4,4,0,0,0,0,0,0
"2362","Mohammad Iqbal ","Canada",2007,2008,5,5,0,0,0,0,0,0
"2363","Mohammad Nazir ","Pakistan",1980,1984,4,4,0,0,0,0,0,0
"2364","Mohammad Talha ","Pakistan",2014,2014,3,3,0,0,0,0,0,0
"2365","Mohammed Siraj ","India",2019,2019,1,1,0,0,0,0,0,0
"2366","Moin-ul-Atiq ","Pakistan",1988,1989,5,5,0,0,0,0,0,0
"2367","Moniruzzaman ","Bangladesh",2003,2003,2,2,0,0,0,0,0,0
"2368","DWO Morgan ","Bermuda",2006,2006,2,2,0,0,0,0,0,0
"2369","EA Moseley ","West Indies",1990,1991,9,8,0,0,0,0,0,0
"2370","PV Mpitsang ","South Africa",1999,1999,2,2,0,0,0,0,0,0
"2371","Mujahid Jamshed ","Pakistan",1997,1997,4,4,0,0,0,0,0,0
"2372","M Mulla ","Canada",2007,2007,1,1,0,0,0,0,0,0
"2373","AMN Munasinghe ","Sri Lanka",1994,1996,5,5,0,0,0,0,0,0
"2374","Munir Dar ","Hong Kong",2008,2008,2,2,0,0,0,0,0,0
"2375","GB Murgatroyd ","Namibia",2003,2003,6,6,0,0,0,0,0,0
"2376","DJ Murray ","New Zealand",1994,1994,1,1,0,0,0,0,0,0
"2377","T Muzarabani ","Zimbabwe",2015,2016,8,8,0,0,0,0,0,0
"2378","Nadeem Ghauri ","Pakistan",1990,1990,6,6,0,0,0,0,0,0
"2379","Nadeem Khan ","Pakistan",1993,1995,2,2,0,0,0,0,0,0
"2380","Naeem Ashraf ","Pakistan",1995,1995,2,2,0,0,0,0,0,0
"2381","J Nagenda ","East (and Central) Africa",1975,1975,1,1,0,0,0,0,0,0
"2382","SS Naik ","India",1974,1974,2,2,0,0,0,0,0,0
"2383","KK Nair ","India",2016,2016,2,2,0,0,0,0,0,0
"2384","Najaf Shah ","Pakistan",2007,2007,1,1,0,0,0,0,0,0
"2385","Najeeb Tarakai ","Afghanistan",2017,2017,1,1,0,0,0,0,0,0
"2386","DP Nannes ","Australia",2009,2009,1,1,0,0,0,0,0,0
"2387","Naseer Malik ","Pakistan",1975,1975,3,3,0,0,0,0,0,0
"2388","Nasim-ul-Ghani ","Pakistan",1973,1973,1,1,0,0,0,0,0,0
"2389","Nasir Aziz ","United Arab Emirates",2014,2015,5,5,0,0,0,0,0,0
"2390","Nasir Hameed ","Hong Kong",2004,2004,1,1,0,0,0,0,0,0
"2391","Nasir Javed ","United States of America",2004,2004,1,1,0,0,0,0,0,0
"2392","Naumanullah ","Pakistan",2008,2008,1,1,0,0,0,0,0,0
"2393","Naved Anjum ","Pakistan",1984,1992,13,13,0,0,0,0,0,0
"2394","MN Nawaz ","Sri Lanka",1998,2002,3,3,0,0,0,0,0,0
"2395","AM Nayar ","India",2009,2009,3,3,0,0,0,0,0,0
"2396","N Ncube ","Zimbabwe",2011,2011,1,1,0,0,0,0,0,0
"2397","A Ndlovu ","Zimbabwe",2019,2019,2,2,0,0,0,0,0,0
"2398","MG Neser ","Australia",2018,2018,2,2,0,0,0,0,0,0
"2399","SO Ngoche ","Kenya",2010,2014,14,14,0,0,0,0,0,0
"2400","IA Nicolson ","Zimbabwe",2010,2010,2,2,0,0,0,0,0,0
"2401","RG Nijman ","Netherlands",2009,2009,1,1,0,0,0,0,0,0
"2402","AA Noffke ","Australia",2008,2008,1,1,0,0,0,0,0,0
"2403","Nurul Abedin ","Bangladesh",1986,1990,4,4,0,0,0,0,0,0
"2404","KJ O'Keeffe ","Australia",1977,1977,2,2,0,0,0,0,0,0
"2405","D Olivier ","South Africa",2019,2019,2,2,0,0,0,0,0,0
"2406","DR O'Sullivan ","New Zealand",1974,1976,3,3,0,0,0,0,0,0
"2407","MB Owens ","New Zealand",1992,1992,1,1,0,0,0,0,0,0
"2408","M Panchal ","Netherlands",2007,2007,1,1,0,0,0,0,0,0
"2409","GK Pandey ","India",1999,1999,2,2,0,0,0,0,0,0
"2410","BA Parchment ","West Indies",2007,2008,7,7,0,0,0,0,0,0
"2411","MW Parkinson ","England",2020,2020,2,2,0,0,0,0,0,0
"2412","SD Parry ","England",2014,2014,2,2,0,0,0,0,0,0
"2413","Parvez Rasool ","India",2014,2014,1,1,0,0,0,0,0,0
"2414","NT Pascal ","West Indies",2009,2009,1,1,0,0,0,0,0,0
"2415","SP Pasqual ","Sri Lanka",1979,1979,2,2,0,0,0,0,0,0
"2416","A Patel ","Canada",2003,2003,2,2,0,0,0,0,0,0
"2417","JM Patel ","Canada",1979,1979,3,3,0,0,0,0,0,0
"2418","KA Patel ","Kenya",2006,2006,2,2,0,0,0,0,0,0
"2419","ML Patel ","Kenya",2004,2006,3,3,0,0,0,0,0,0
"2420","RGM Patel ","India",1988,1988,1,1,0,0,0,0,0,0
"2421","R Pathan ","Canada",2013,2013,1,1,0,0,0,0,0,0
"2422","BMW Patterson ","Scotland",1999,1999,3,3,0,0,0,0,0,0
"2423","GE Peckover ","Zimbabwe",1983,1983,3,3,0,0,0,0,0,0
"2424","KG Perera ","Sri Lanka",1986,1986,1,1,0,0,0,0,0,0
"2425","N Phillip ","West Indies",1978,1978,1,1,0,0,0,0,0,0
"2426","HSM Pieris ","Sri Lanka",1975,1975,3,3,0,0,0,0,0,0
"2427","K Pierre ","West Indies",2019,2020,3,3,0,0,0,0,0,0
"2428","ADJ Pitcher ","Bermuda",2007,2007,3,3,0,0,0,0,0,0
"2429","PI Pocock ","England",1985,1985,1,1,0,0,0,0,0,0
"2430","DJ Pringle ","East (and Central) Africa",1975,1975,2,2,0,0,0,0,0,0
"2431","CA Pujara ","India",2013,2014,5,4,0,0,0,0,0,0
"2432","Y Punja ","United Arab Emirates",2015,2015,1,1,0,0,0,0,0,0
"2433","M Pushpakumara ","Sri Lanka",2009,2010,3,2,0,0,0,0,0,0
"2434","CT Radley ","England",1978,1978,4,4,0,0,0,0,0,0
"2435","Rafiqul Alam ","Bangladesh",1986,1986,2,2,0,0,0,0,0,0
"2436","Rafiqul Islam ","Bangladesh",2002,2002,1,1,0,0,0,0,0,0
"2437","RR Ramdass ","West Indies",2005,2005,1,1,0,0,0,0,0,0
"2438","D Ramnarine ","West Indies",1997,2001,4,4,0,0,0,0,0,0
"2439","DR Ramsammy ","Canada",2012,2012,1,1,0,0,0,0,0,0
"2440","Ramveer Rai ","United Arab Emirates",2004,2004,1,1,0,0,0,0,0,0
"2441","AN Ranasinghe ","Sri Lanka",1975,1982,9,9,0,0,0,0,0,0
"2442","N Ranatunga ","Sri Lanka",1993,1993,2,2,0,0,0,0,0,0
"2443","Randhir Singh ","India",1981,1983,2,2,0,0,0,0,0,0
"2444","Rashid Zia ","United States of America",2004,2004,2,2,0,0,0,0,0,0
"2445","NLK Ratnayake ","Sri Lanka",1989,1990,2,2,0,0,0,0,0,0
"2446","SS Raul ","India",1998,1998,2,2,0,0,0,0,0,0
"2447","Raza Hasan ","Pakistan",2014,2014,1,1,0,0,0,0,0,0
"2448","RE Redmond ","New Zealand",1973,1973,2,2,0,0,0,0,0,0
"2449","B Regmi ","Nepal",2018,2019,4,4,0,0,0,0,0,0
"2450","CA Reid ","United States of America",2004,2004,2,2,0,0,0,0,0,0
"2451","RA Reifer ","West Indies",2019,2019,2,2,0,0,0,0,0,0
"2452","CEB Rice ","South Africa",1991,1991,3,3,0,0,0,0,0,0
"2453","EJ Richardson ","Ireland",2013,2013,2,2,0,0,0,0,0,0
"2454","EB Ringera ","Kenya",2011,2011,1,1,0,0,0,0,0,0
"2455","HP Rinke ","Zimbabwe",2006,2006,18,18,0,0,0,0,0,0
"2456","Rizwan Latif ","United Arab Emirates",2004,2004,1,1,0,0,0,0,0,0
"2457","SJ Roberts ","New Zealand",1990,1990,2,2,0,0,0,0,0,0
"2458","Robiul Islam ","Bangladesh",2013,2013,3,3,0,0,0,0,0,0
"2459","TS Roland-Jones ","England",2017,2017,1,1,0,0,0,0,0,0
"2460","Saad Ali ","Pakistan",2019,2019,2,2,0,0,0,0,0,0
"2461","Saad Nasim ","Pakistan",2015,2015,3,3,0,0,0,0,0,0
"2462","Sagar Pun ","Nepal",2018,2018,1,1,0,0,0,0,0,0
"2463","Saiful Islam ","Bangladesh",1990,1997,7,7,0,0,0,0,0,0
"2464","Sajjad Ahmed ","Bangladesh",1995,1995,2,2,0,0,0,0,0,0
"2465","Sajjad Akbar ","Pakistan",1990,1990,2,2,0,0,0,0,0,0
"2466","Saleem Pervez ","Pakistan",1980,1980,1,1,0,0,0,0,0,0
"2467","Saleem Raza ","United Arab Emirates",1994,1996,6,6,0,0,0,0,0,0
"2468","Salman Faris ","United Arab Emirates",2014,2014,3,3,0,0,0,0,0,0
"2469","Salman Farooq ","United Arab Emirates",2014,2014,1,1,0,0,0,0,0,0
"2470","Samiullah Khan ","Pakistan",2008,2008,2,2,0,0,0,0,0,0
"2471","Sami Aslam ","Pakistan",2015,2016,4,4,0,0,0,0,0,0
"2472","Sami Faridi ","Canada",2008,2008,3,3,0,0,0,0,0,0
"2473","GS Sandhu ","Australia",2015,2015,2,2,0,0,0,0,0,0
"2474","Saqib Zulfiqar ","Netherlands",2019,2019,1,1,0,0,0,0,0,0
"2475","P Sarraf ","Nepal",2019,2019,2,2,0,0,0,0,0,0
"2476","Sayed Shirzad ","Afghanistan",2019,2019,2,1,0,0,0,0,0,0
"2477","RH Scholte ","Netherlands",2002,2003,5,5,0,0,0,0,0,0
"2478","BN Schultz ","South Africa",1992,1992,1,1,0,0,0,0,0,0
"2479","GR Sealy ","Canada",1979,1979,3,3,0,0,0,0,0,0
"2480","TAP Sekhar ","India",1983,1985,4,4,0,0,0,0,0,0
"2481","Shafiuddin Ahmed ","Bangladesh",1997,2000,11,11,0,0,0,0,0,0
"2482","Shaheedur Rahman ","Bangladesh",1986,1986,2,2,0,0,0,0,0,0
"2483","Shahid Anwar ","Pakistan",1996,1996,1,1,0,0,0,0,0,0
"2484","Shehzad Altaf ","United Arab Emirates",1996,1996,2,2,0,0,0,0,0,0
"2485","Shahzad Khan ","Canada",2007,2007,1,1,0,0,0,0,0,0
"2486","Shahzaib Hasan ","Pakistan",2010,2010,3,3,0,0,0,0,0,0
"2487","Shakeel Ahmed jnr ","Pakistan",1995,1995,2,2,0,0,0,0,0,0
"2488","Shakeel Khan ","Pakistan",1987,1987,1,1,0,0,0,0,0,0
"2489","A Shamshudeen ","Canada",2007,2007,1,1,0,0,0,0,0,0
"2490","JNK Shannon ","Ireland",2013,2013,1,1,0,0,0,0,0,0
"2491","Shariful Haque ","Bangladesh",1998,1998,1,1,0,0,0,0,0,0
"2492","PH Sharma ","India",1976,1976,2,2,0,0,0,0,0,0
"2493","PP Shaw ","India",2020,2020,3,3,0,0,0,0,0,0
"2494","AP Sheahan ","Australia",1972,1972,3,3,0,0,0,0,0,0
"2495","Sheikh Salahuddin ","Bangladesh",1997,1997,6,6,0,0,0,0,0,0
"2496","V Shetty ","United Arab Emirates",2008,2014,2,2,0,0,0,0,0,0
"2497","M Shezi ","South Africa",2014,2014,1,1,0,0,0,0,0,0
"2498","S Shivnarine ","West Indies",1978,1978,1,1,0,0,0,0,0,0
"2499","Shubman Gill ","India",2019,2019,2,2,0,0,0,0,0,0
"2500","Shuvagata Hom ","Bangladesh",2011,2011,4,4,0,0,0,0,0,0
"2501","JD Siddons ","Australia",1988,1988,1,1,0,0,0,0,0,0
"2502","EHSN Silva ","United Arab Emirates",2008,2008,1,1,0,0,0,0,0,0
"2503","KJ Silva ","Sri Lanka",1995,1995,1,1,0,0,0,0,0,0
"2504","CEW Silverwood ","England",1996,2001,7,7,0,0,0,0,0,0
"2505","Simandeep Singh ","Hong Kong",2018,2018,1,1,0,0,0,0,0,0
"2506","RP Singh ","India",1986,1986,2,2,0,0,0,0,0,0
"2507","Skhawat Ali ","Hong Kong",2008,2014,4,4,0,0,0,0,0,0
"2508","WN Slack ","England",1986,1986,2,2,0,0,0,0,0,0
"2509","CL Smith ","England",1984,1984,4,4,0,0,0,0,0,0
"2510","DM Smith ","England",1986,1990,2,2,0,0,0,0,0,0
"2511","M Smith ","Bermuda",2008,2008,1,1,0,0,0,0,0,0
"2512","MJ Smith ","Scotland",1999,1999,5,5,0,0,0,0,0,0
"2513","RAJ Smith ","Scotland",2016,2016,2,2,0,0,0,0,0,0
"2514","G Snyman ","Namibia",2003,2003,5,5,0,0,0,0,0,0
"2515","Sohail Butt ","United Arab Emirates",1994,1994,2,2,0,0,0,0,0,0
"2516","S Somasunder ","India",1996,1996,2,2,0,0,0,0,0,0
"2517","TE Srinivasan ","India",1980,1981,2,2,0,0,0,0,0,0
"2518","RW Staple ","United States of America",2004,2004,2,2,0,0,0,0,0,0
"2519","NA Statham ","Netherlands",2003,2009,3,3,0,0,0,0,0,0
"2520","MP Stead ","Canada",1979,1979,2,2,0,0,0,0,0,0
"2521","RD Steede ","Bermuda",2006,2008,8,8,0,0,0,0,0,0
"2522","DS Steele ","England",1976,1976,1,1,0,0,0,0,0,0
"2523","SL Stewart ","New Zealand",2010,2010,4,4,0,0,0,0,0,0
"2524","PJR Steyn ","South Africa",1995,1995,1,1,0,0,0,0,0,0
"2525","OP Stone ","England",2018,2018,4,3,0,0,0,0,0,0
"2526","Subashis Roy ","Bangladesh",2016,2016,1,1,0,0,0,0,0,0
"2527","Sultan Ahmed ","United Arab Emirates",2019,2019,2,2,0,0,0,0,0,0
"2528","GP Sulzberger ","New Zealand",2000,2000,3,3,0,0,0,0,0,0
"2529","S Sumar ","East (and Central) Africa",1975,1975,1,1,0,0,0,0,0,0
"2530","Sunzamul Islam ","Bangladesh",2017,2018,3,3,0,0,0,0,0,0
"2531","SJ Swanepoel ","Namibia",2003,2003,5,5,0,0,0,0,0,0
"2532","Tabarak Dar ","Hong Kong",2004,2008,4,4,0,0,0,0,0,0
"2533","AR Tait ","New Zealand",1998,1999,5,5,0,0,0,0,0,0
"2534","Tanvir Mehdi ","Pakistan",1992,1992,1,1,0,0,0,0,0,0
"2535","Tariq Javed ","Canada",1979,1979,3,3,0,0,0,0,0,0
"2536","JP Taylor ","England",1993,1993,1,1,0,0,0,0,0,0
"2537","LB Taylor ","England",1986,1986,2,2,0,0,0,0,0,0
"2538","DJ Terbrugge ","South Africa",2000,2000,4,4,0,0,0,0,0,0
"2539","DJ ter Braak ","Netherlands",2018,2018,2,2,0,0,0,0,0,0
"2540","VAB Tewarie ","Netherlands",2011,2011,1,1,0,0,0,0,0,0
"2541","JG Thomas ","England",1986,1987,3,3,0,0,0,0,0,0
"2542","O Thomas ","West Indies",2018,2020,20,19,0,0,0,0,0,0
"2543","EP Thompson ","New Zealand",2009,2009,1,1,0,0,0,0,0,0
"2544","PIC Thompson ","West Indies",1997,1997,2,2,0,0,0,0,0,0
"2545","AL Thomson ","Australia",1971,1971,1,1,0,0,0,0,0,0
"2546","MH Tissera ","Sri Lanka",1975,1975,3,3,0,0,0,0,0,0
"2547","GC Tonge ","West Indies",2009,2009,5,5,0,0,0,0,0,0
"2548","PM Toohey ","Australia",1978,1979,5,4,0,0,0,0,0,0
"2549","GS Trimble ","Australia",1986,1986,2,2,0,0,0,0,0,0
"2550","MS Tshabalala ","South Africa",2007,2007,4,4,0,0,0,0,0,0
"2551","CK Tshuma ","Zimbabwe",2020,2020,2,2,0,0,0,0,0,0
"2552","CM Tuckett ","West Indies",1998,1998,1,1,0,0,0,0,0,0
"2553","ML Udawatte ","Sri Lanka",2008,2008,9,9,0,0,0,0,0,0
"2554","JD Unadkat ","India",2013,2013,7,7,0,0,0,0,0,0
"2555","Usman Mushtaq ","United Arab Emirates",2015,2015,1,1,0,0,0,0,0,0
"2556","T van der Gugten ","Netherlands",2012,2013,4,4,0,0,0,0,0,0
"2557","MG Vandort ","Sri Lanka",2006,2006,1,1,0,0,0,0,0,0
"2558","PA van Meekeren ","Netherlands",2013,2019,5,5,0,0,0,0,0,0
"2559","MWA van Nierop ","Netherlands",2006,2006,2,2,0,0,0,0,0,0
"2560","KJJ van Noortwijk ","Netherlands",1996,2003,9,9,0,0,0,0,0,0
"2561","BO van Rooi ","Namibia",2003,2003,3,3,0,0,0,0,0,0
"2562","RJ van Vuuren ","Namibia",2003,2003,5,5,0,0,0,0,0,0
"2563","CJPG van Zyl ","South Africa",1992,1992,2,2,0,0,0,0,0,0
"2564","JCB Vaughan ","Canada",1979,1979,3,3,0,0,0,0,0,0
"2565","M Venkataramana ","India",1988,1988,1,1,0,0,0,0,0,0
"2566","GE Vivian ","New Zealand",1973,1973,1,1,0,0,0,0,0,0
"2567","DM Vonhagt ","Sri Lanka",1985,1985,1,1,0,0,0,0,0,0
"2568","Wahidul Gani ","Bangladesh",1988,1988,1,1,0,0,0,0,0,0
"2569","KP Walmsley ","New Zealand",2003,2003,2,2,0,0,0,0,0,0
"2570","R Walters ","Namibia",2003,2003,2,2,0,0,0,0,0,0
"2571","S Walusimbi ","East (and Central) Africa",1975,1975,3,3,0,0,0,0,0,0
"2572","Waqas Khan ","Hong Kong",2015,2017,8,8,0,0,0,0,0,0
"2573","Wasim Haider ","Pakistan",1992,1992,3,3,0,0,0,0,0,0
"2574","SL Watkin ","England",1994,1994,4,4,0,0,0,0,0,0
"2575","M Watkinson ","England",1996,1996,1,1,0,0,0,0,0,0
"2576","GD Watson ","Australia",1972,1972,2,2,0,0,0,0,0,0
"2577","RJ Webb ","New Zealand",1983,1983,3,3,0,0,0,0,0,0
"2578","AP Weerakkody ","Sri Lanka",1994,1994,1,1,0,0,0,0,0,0
"2579","S Weerakoon ","Sri Lanka",2012,2012,2,2,0,0,0,0,0,0
"2580","AP Wells ","England",1995,1995,1,1,0,0,0,0,0,0
"2581","CM Wells ","England",1985,1985,2,2,0,0,0,0,0,0
"2582","MD Wettimuny ","Sri Lanka",1983,1983,1,1,0,0,0,0,0,0
"2583","SRD Wettimuny ","Sri Lanka",1975,1979,3,3,0,0,0,0,0,0
"2584","K Whatham ","Canada",2011,2011,1,1,0,0,0,0,0,0
"2585","DF Whatmore ","Australia",1980,1980,1,1,0,0,0,0,0,0
"2586","RK Whelan ","Ireland",2007,2007,2,2,0,0,0,0,0,0
"2587","RPAH Wickramaratne ","Sri Lanka",1993,1993,3,3,0,0,0,0,0,0
"2588","D Wiese ","South Africa",2015,2016,6,6,0,0,0,0,0,0
"2589","KOK Williams ","West Indies",2017,2018,8,8,0,0,0,0,0,0
"2590","JG Williamson ","Scotland",1999,1999,2,2,0,0,0,0,0,0
"2591","CM Willoughby ","South Africa",2000,2003,3,3,0,0,0,0,0,0
"2592","AJ Woodcock ","Australia",1974,1974,1,1,0,0,0,0,0,0
"2593","LJ Woodcock ","New Zealand",2011,2011,4,4,0,0,0,0,0,0
"2594","T Yohannan ","India",2002,2002,3,3,0,0,0,0,0,0
"2595","Yunus Badat ","East (and Central) Africa",1975,1975,2,2,0,0,0,0,0,0
"2596","Zafar Gohar ","Pakistan",2015,2015,1,1,0,0,0,0,0,0
"2597","Zaheer Maqsood ","United Arab Emirates",2015,2015,2,2,0,0,0,0,0,0
"2598","Zahid Ahmed ","Pakistan",1987,1987,2,2,0,0,0,0,0,0
"2599","Zahid Razzak ","Bangladesh",1988,1990,3,3,0,0,0,0,0,0
"2600","Zahid Shah ","United Arab Emirates",2008,2008,2,2,0,0,0,0,0,0
"2601","MZ Zahir ","Canada",2009,2009,1,1,0,0,0,0,0,0
"2602","Zahir Khan ","Afghanistan",2019,2019,1,1,0,0,0,0,0,0
"2603","Zain Abbas ","Hong Kong",2008,2008,1,1,0,0,0,0,0,0
"2604","Zakir Hasan ","Bangladesh",1997,1997,1,1,0,0,0,0,0,0
"2605","Zakir Hossain ","Bangladesh",1998,1998,1,1,0,0,0,0,0,0
"2606","Zakir Khan ","Pakistan",1984,1990,17,16,0,0,0,0,0,0
"2607","Zakiullah Zaki ","Afghanistan",2012,2012,1,1,0,0,0,0,0,0
"2608","Zawar Farid ","United Arab Emirates",2020,2020,1,1,0,0,0,0,0,0
"2609","Zeeshan Siddiqi ","Canada",2012,2014,2,2,0,0,0,0,0,0
"2610","Zulfiqar Babar ","Pakistan",2014,2015,5,5,0,0,0,0,0,0
"2611","BC Fortuin ","South Africa",2020,2020,1,NA,NA,NA,NA,NA,NA,NA
