"Player","Start","End","Matches","Innings","Dismissals","Caught","CaughtFielder","CaughtBehind","Stumped","MaxDismissalsInnings"
"KC Sangakkara ",2000,2015,404,397,501,402,19,383,99,5
"AC Gilchrist ",1996,2008,287,286,472,417,0,417,55,6
"MS Dhoni ",2004,2019,350,345,444,321,0,321,123,6
"MV Boucher ",1998,2011,295,291,425,403,1,402,22,6
"Moin Khan ",1990,2004,219,217,287,214,0,214,73,5
"BB McCullum ",2002,2016,260,257,277,262,35,227,15,5
"IA Healy ",1988,1997,168,168,233,194,0,194,39,4
"Mushfiqur Rahim ",2006,2020,218,217,225,181,2,179,44,5
"Rashid Latif ",1992,2003,166,164,220,182,0,182,38,5
"DPMD Jayawardene ",1998,2015,448,443,218,218,218,0,0,4
"R Dravid ",1996,2011,344,341,210,196,124,72,14,4
"RS Kaluwitharana ",1990,2004,189,188,207,132,1,131,75,5
"PJL Dujon ",1981,1991,169,168,204,183,0,183,21,4
"JC Buttler ",2012,2019,142,138,202,171,0,171,31,6
"RD Jacobs ",1996,2004,147,145,189,160,0,160,29,6
"Kamran Akmal ",2002,2017,157,154,188,157,1,156,31,5
"D Ramdin ",2005,2016,139,137,188,181,0,181,7,5
"AB de Villiers ",2005,2018,228,223,181,176,83,93,5,5
"BJ Haddin ",2001,2015,126,124,181,170,0,170,11,5
"AJ Stewart ",1989,2003,170,169,174,159,11,148,15,6
"Q de Kock ",2013,2020,121,116,173,164,0,164,9,6
"A Flower ",1992,2003,213,212,173,141,8,133,32,5
"DJ Richardson ",1991,1998,122,121,165,148,0,148,17,5
"RT Ponting ",1995,2012,375,372,160,160,160,0,0,3
"M Azharuddin ",1985,2000,334,332,156,156,156,0,0,4
"NR Mongia ",1994,2000,140,139,154,110,0,110,44,5
"BRM Taylor ",2004,2020,196,196,154,125,29,96,29,5
"T Taibu ",2001,2012,150,150,147,114,2,112,33,4
"AC Parore ",1992,2002,179,178,141,116,5,111,25,5
"Sarfaraz Ahmed ",2007,2019,116,114,140,116,0,116,24,6
"SR Tendulkar ",1989,2012,463,456,140,140,140,0,0,4
"LRPL Taylor ",2006,2020,232,228,139,139,139,0,0,4
"Younis Khan ",2000,2015,265,260,135,135,130,5,0,4
"SP Fleming ",1994,2007,280,276,133,133,133,0,0,4
"JH Kallis ",1996,2014,328,324,131,131,131,0,0,3
"M Muralitharan ",1993,2011,350,347,130,130,130,0,0,3
"V Kohli ",2008,2020,248,246,128,128,128,0,0,3
"AR Border ",1979,1994,273,270,127,127,127,0,0,3
"Shahid Afridi ",1996,2015,398,392,127,127,127,0,0,2
"Khaled Mashud ",1995,2006,126,126,126,91,0,91,35,5
"TM Dilshan ",1999,2016,330,325,124,123,118,5,1,3
"CH Gayle ",1999,2019,301,294,124,124,124,0,0,3
"RW Marsh ",1971,1984,92,92,124,120,0,120,4,5
"ST Jayasuriya ",1989,2011,445,441,123,123,123,0,0,3
"CL Hooper ",1987,2003,227,225,120,120,120,0,0,4
"BC Lara ",1990,2007,299,296,120,120,120,0,0,3
"L Ronchi ",2008,2017,85,83,117,105,0,105,12,4
"MS Wade ",2012,2017,94,94,117,108,0,108,9,5
"Inzamam-ul-Haq ",1991,2007,378,373,113,113,113,0,0,3
"SR Waugh ",1986,2002,325,324,111,111,111,0,0,3
"RS Mahanama ",1986,1999,213,212,109,109,109,0,0,3
"PD Collingwood ",2001,2011,197,197,108,108,108,0,0,3
"HH Gibbs ",1996,2010,248,246,108,108,108,0,0,3
"SM Pollock ",1996,2008,303,300,108,108,108,0,0,2
"ME Waugh ",1988,2002,244,243,108,108,108,0,0,3
"MJ Clarke ",2003,2015,245,243,106,106,106,0,0,4
"MEK Hussey ",2004,2012,185,184,105,105,105,0,0,3
"JN Rhodes ",1992,2003,245,242,105,105,105,0,0,5
"GC Smith ",2002,2013,197,196,105,105,105,0,0,4
"NJ O'Brien ",2006,2018,103,99,104,90,8,82,14,5
"Saleem Yousuf ",1982,1990,86,86,103,81,0,81,22,4
"SK Raina ",2005,2018,226,223,102,102,102,0,0,3
"SC Ganguly ",1992,2007,311,309,100,100,100,0,0,3
"IVA Richards ",1975,1991,187,186,100,100,100,0,0,3
"Shoaib Malik ",1999,2019,287,285,98,98,98,0,0,2
"CZ Harris ",1990,2004,250,247,96,96,96,0,0,4
"PA de Silva ",1984,2003,308,307,95,95,95,0,0,3
"HP Tillakaratne ",1986,2003,200,199,95,89,50,39,6,5
"Yuvraj Singh ",2000,2017,304,298,94,94,94,0,0,3
"SD Hope ",2016,2020,78,75,93,83,0,83,10,5
"V Sehwag ",1999,2013,251,246,93,93,93,0,0,3
"MJ Guptill ",2009,2020,183,181,91,91,91,0,0,4
"Ijaz Ahmed ",1986,2000,250,249,90,90,90,0,0,3
"KS More ",1984,1993,94,93,90,63,0,63,27,5
"Umar Akmal ",2009,2019,121,119,90,77,32,45,13,5
"TWM Latham ",2012,2020,99,97,89,82,26,56,7,5
"Mohammad Shahzad ",2009,2019,84,83,89,64,1,63,25,5
"DL Vettori ",1997,2015,295,289,88,88,88,0,0,2
"Wasim Akram ",1984,2003,356,352,88,88,88,0,0,3
"HM Amla ",2008,2019,181,176,87,87,87,0,0,4
"GW Flower ",1992,2010,221,220,86,86,86,0,0,2
"IDS Smith ",1980,1992,98,97,86,81,1,80,5,3
"A Kumble ",1990,2007,271,268,85,85,85,0,0,2
"Mohammad Hafeez ",2003,2019,218,216,85,85,85,0,0,2
"NJ Astle ",1995,2007,223,219,83,83,83,0,0,3
"EJG Morgan ",2006,2020,236,230,83,83,80,3,0,3
"GC Wilson ",2007,2019,105,101,83,73,24,49,10,4
"JP Duminy ",2004,2019,199,195,82,82,82,0,0,3
"A Symonds ",1998,2009,198,196,82,82,82,0,0,4
"F du Plessis ",2011,2019,143,141,81,81,81,0,0,3
"Saleem Malik ",1982,1999,283,277,81,81,80,1,0,4
"SK Warne ",1993,2005,194,193,80,80,80,0,0,3
"UDU Chandana ",1994,2007,147,146,79,79,79,0,0,3
"MJ Prior ",2004,2011,68,68,79,71,2,69,8,6
"RG Sharma ",2007,2020,224,223,77,77,77,0,0,3
"ADR Campbell ",1992,2003,188,187,76,76,74,2,0,3
"MH Cross ",2014,2019,52,51,75,71,0,71,4,6
"RB Richardson ",1983,1996,224,222,75,75,75,0,0,4
"JE Root ",2013,2020,146,142,74,74,74,0,0,3
"JC Adams ",1992,2001,127,127,73,68,42,26,5,5
"DJ Bravo ",2004,2014,164,161,73,73,73,0,0,3
"S Chanderpaul ",1994,2011,268,264,73,73,73,0,0,2
"WJ Cronje ",1992,2000,188,186,73,73,73,0,0,2
"Javed Miandad ",1975,1996,233,229,73,71,70,1,2,3
"SB Styris ",1999,2011,188,185,73,73,73,0,0,3
"E Chigumbura ",2004,2018,213,212,72,72,72,0,0,4
"GO Jones ",2004,2014,51,51,72,68,0,68,4,5
"Harbhajan Singh ",1998,2015,236,231,71,71,71,0,0,3
"N Kapil Dev ",1978,1994,225,222,71,71,71,0,0,3
"KD Karthik ",2004,2019,94,94,71,64,29,35,7,4
"H Masakadza ",2001,2019,209,209,71,71,71,0,0,2
"MS Atapattu ",1990,2007,268,266,70,70,70,0,0,3
"MG Bevan ",1994,2004,232,230,69,69,69,0,0,3
"DR Martyn ",1992,2006,208,205,69,69,69,0,0,3
"A Bagai ",2003,2013,62,62,68,59,1,58,9,4
"CO Browne ",1995,2005,46,46,68,59,0,59,9,5
"ML Hayden ",1993,2008,161,158,68,68,68,0,0,2
"DJG Sammy ",2004,2015,126,124,67,67,67,0,0,3
"SPD Smith ",2010,2020,125,125,67,67,67,0,0,3
"SO Tikolo ",1996,2014,135,135,67,67,67,0,0,3
"CL Cairns ",1991,2006,215,214,66,66,66,0,0,3
"LD Chandimal ",2010,2019,146,143,66,59,28,31,7,4
"MD Crowe ",1982,1995,143,141,66,66,66,0,0,3
"Misbah-ul-Haq ",2002,2015,162,160,66,66,66,0,0,4
"C Kieswetter ",2010,2013,46,45,65,53,1,52,12,5
"GJ Maxwell ",2012,2019,110,110,65,65,65,0,0,4
"GA Hick ",1991,2001,120,119,64,64,64,0,0,3
"Mahmudullah ",2007,2020,188,187,64,64,64,0,0,3
"KJ O'Brien ",2006,2020,145,141,64,64,64,0,0,3
"WTS Porterfield ",2006,2020,139,134,64,64,64,0,0,3
"SR Watson ",2002,2015,190,189,64,64,64,0,0,2
"A Ranatunga ",1982,1999,269,268,63,63,63,0,0,3
"DJ Cullinan ",1993,2000,138,135,62,62,62,0,0,3
"S Dhawan ",2010,2020,136,134,62,62,62,0,0,4
"G Kirsten ",1993,2003,185,183,62,61,60,1,1,3
"Mashrafe Mortaza ",2001,2020,220,220,62,62,62,0,0,2
"NLTC Perera ",2009,2020,164,160,62,62,62,0,0,2
"Wasim Bari ",1973,1984,51,50,62,52,0,52,10,4
"AL Logie ",1981,1993,158,158,61,61,61,0,0,3
"DA Miller ",2010,2020,132,128,61,61,61,0,0,3
"KA Pollard ",2007,2020,113,111,61,61,61,0,0,4
"AJ Finch ",2013,2020,126,126,60,60,60,0,0,3
"WPUJC Vaas ",1994,2008,322,320,60,60,60,0,0,2
"KS Williamson ",2010,2020,151,150,60,60,60,0,0,3
"DL Haynes ",1978,1994,238,236,59,59,59,0,0,2
"A Jadeja ",1992,2000,196,195,59,59,59,0,0,2
"RA Jadeja ",2009,2020,165,164,58,58,58,0,0,2
"Mohammad Yousuf ",1998,2010,288,285,58,58,58,0,0,2
"MA Ouma ",2004,2014,80,80,58,48,5,43,10,5
"KO Otieno ",1996,2009,90,90,57,43,3,40,14,4
"AJ Strauss ",2003,2011,127,127,57,57,57,0,0,3
"MA Taylor ",1989,1997,113,113,56,56,56,0,0,4
"RA Harper ",1983,1996,105,105,55,55,55,0,0,3
"M Kaif ",2002,2006,125,122,55,55,55,0,0,4
"Mohammad Nabi ",2009,2019,124,121,55,55,55,0,0,3
"TD Paine ",2009,2018,35,34,55,51,0,51,4,5
"PV Simmons ",1987,1999,143,143,55,55,55,0,0,4
"DA Warner ",2009,2020,123,123,55,55,55,0,0,2
"IR Bell ",2004,2015,161,160,54,54,54,0,0,3
"DM Jones ",1984,1994,164,164,54,54,54,0,0,2
"B Lee ",2000,2012,221,217,54,54,54,0,0,3
"Tamim Iqbal ",2007,2020,207,206,54,54,54,0,0,2
"JM Anderson ",2002,2015,194,192,53,53,53,0,0,3
"AD Mathews ",2008,2020,217,213,53,53,53,0,0,3
"JR Murray ",1992,1999,55,55,53,46,2,44,7,3
"AB Agarkar ",1998,2007,191,188,52,52,52,0,0,2
"CS Baugh ",2003,2012,47,46,51,39,0,39,12,4
"JDP Oram ",2001,2012,160,159,51,51,51,0,0,2
"JG Wright ",1978,1992,149,147,51,51,51,0,0,2
"JO Holder ",2013,2020,115,112,50,50,50,0,0,2
"MN Samuels ",2000,2018,207,207,50,50,50,0,0,2
"Shakib Al Hasan ",2006,2019,206,205,50,50,50,0,0,3
"WU Tharanga ",2005,2019,235,228,50,50,50,0,0,3
"P Utseya ",2004,2015,164,164,50,50,50,0,0,2
"SC Williams ",2005,2020,133,132,50,50,50,0,0,3
"Aamer Sohail ",1990,2000,156,154,49,49,49,0,0,2
"AP Gurusinha ",1985,1996,147,147,49,49,47,2,0,2
"WB Phillips ",1982,1986,48,48,49,42,0,42,7,4
"ME Trescothick ",2000,2006,123,121,49,49,45,4,0,3
"KC Wessels ",1983,1994,109,106,49,49,49,0,0,4
"RP Arnold ",1997,2007,180,179,48,48,48,0,0,2
"GJ Bailey ",2012,2016,90,90,48,48,48,0,0,3
"AM Rahane ",2011,2018,90,87,48,48,48,0,0,2
"J Smits ",2003,2009,38,38,48,41,0,41,7,4
"AT Carey ",2018,2020,36,36,47,42,0,42,5,5
"N Dickwella ",2014,2019,52,52,47,38,0,38,9,4
"A Flintoff ",1999,2009,141,140,47,47,47,0,0,3
"RC Russell ",1987,1998,40,40,47,41,0,41,6,3
"KMDN Kulasekara ",2003,2017,184,181,46,46,46,0,0,3
"MDKJ Perera ",2013,2020,101,100,46,43,17,26,3,4
"HH Streak ",1993,2005,189,188,46,46,46,0,0,2
"CEL Ambrose ",1988,2000,176,175,45,45,45,0,0,3
"DC Boon ",1984,1995,181,181,45,45,45,0,0,2
"GA Gooch ",1976,1995,125,125,45,45,45,0,0,2
"CG Greenidge ",1975,1991,128,127,45,45,45,0,0,2
"RR Sarwan ",2000,2013,181,176,45,45,45,0,0,2
"PR Stirling ",2008,2020,117,113,45,45,45,0,0,3
"BA Stokes ",2011,2019,95,92,45,45,45,0,0,3
"D Williams ",1988,1997,36,35,45,35,0,35,10,4
"DI Gower ",1978,1991,114,114,44,44,44,0,0,3
"NV Knight ",1996,2003,100,100,44,44,44,0,0,2
"CD McMillan ",1997,2007,197,193,44,44,44,0,0,2
"DO Obuya ",2001,2012,74,74,44,39,16,23,5,4
"CR Woakes ",2011,2020,101,97,44,44,44,0,0,4
"Z Khan ",2000,2012,200,197,43,43,43,0,0,3
"CO Obuya ",2001,2014,104,104,43,43,43,0,0,3
"RL Powell ",1999,2005,109,107,43,43,43,0,0,3
"CMW Read ",2000,2006,36,35,43,41,0,41,2,5
"CR Ervine ",2010,2019,93,92,42,42,42,0,0,4
"BM McMillan ",1991,1998,78,77,42,42,42,0,0,3
"KD Mills ",2001,2015,170,169,42,42,42,0,0,3
"Saeed Anwar ",1989,2003,247,242,42,42,42,0,0,3
"V Sibanda ",2003,2016,127,127,42,42,42,0,0,2
"K Srikkanth ",1981,1992,146,145,42,42,42,0,0,2
"GP Thorpe ",1993,2002,82,81,42,42,42,0,0,3
"NL McCullum ",2009,2015,84,83,41,41,41,0,0,4
"KR Rutherford ",1985,1995,121,121,41,41,41,0,0,4
"L Vincent ",2001,2007,102,100,41,41,39,2,0,2
"JV Coney ",1979,1987,88,86,40,40,40,0,0,3
"N Hussain ",1989,2003,88,88,40,40,40,0,0,2
"KP Pietersen ",2004,2013,136,135,40,40,40,0,0,2
"Saqlain Mushtaq ",1995,2003,169,166,40,40,40,0,0,2
"RJ Shastri ",1981,1992,150,148,40,40,40,0,0,2
"Sikandar Raza ",2013,2020,100,99,40,40,40,0,0,3
"SV Carlisle ",1995,2005,111,111,39,39,39,0,0,3
"VVS Laxman ",1998,2006,86,85,39,39,39,0,0,4
"CH Lloyd ",1973,1985,87,87,39,39,39,0,0,3
"BKG Mendis ",2016,2020,76,75,39,39,37,2,0,3
"PA Patel ",2003,2012,38,36,39,30,0,30,9,4
"TG Southee ",2008,2020,143,142,39,39,39,0,0,3
"TE Blain ",1986,1994,38,38,38,37,1,36,1,4
"DSBP Kuruppu ",1983,1990,54,54,38,30,4,26,8,4
"DL Murray ",1973,1980,26,26,38,37,0,37,1,4
"HDRL Thirimanne ",2010,2019,127,125,38,38,38,0,0,2
"Azhar Mahmood ",1996,2007,143,140,37,37,37,0,0,2
"JM Bairstow ",2011,2020,77,74,37,35,22,13,2,4
"AG Cremer ",2009,2018,96,95,37,37,37,0,0,2
"GD McGrath ",1993,2007,250,248,37,37,37,0,0,3
"S Matsikenyeri ",2002,2015,113,113,37,37,37,0,0,3
"Najibullah Zadran ",2012,2019,67,66,37,37,37,0,0,3
"BKV Prasad ",1994,2001,161,160,37,37,37,0,0,3
"Sabbir Rahman ",2014,2019,66,65,37,37,37,0,0,3
"RG Twose ",1995,2001,87,87,37,37,37,0,0,2
"DB Vengsarkar ",1976,1991,129,127,37,37,37,0,0,3
"CL White ",2005,2018,91,90,37,37,37,0,0,3
"Babar Azam ",2015,2019,74,73,36,36,36,0,0,2
"J Botha ",2005,2012,78,77,36,36,36,0,0,3
"IT Botham ",1976,1992,116,116,36,36,36,0,0,2
"AN Cook ",2006,2014,92,91,36,36,36,0,0,2
"HH Dippenaar ",1999,2007,107,106,36,36,34,2,0,3
"GH Dockrell ",2010,2019,87,85,36,36,36,0,0,2
"G Gambhir ",2003,2013,147,144,36,36,36,0,0,3
"GB Hogg ",1996,2008,123,121,36,36,36,0,0,2
"Imran Khan ",1974,1992,175,172,36,36,36,0,0,3
"SMH Kirmani ",1976,1986,49,48,36,27,0,27,9,5
"GJ Whittall ",1993,2003,147,146,36,36,36,0,0,4
"Abdul Razzaq ",1996,2011,265,262,35,35,35,0,0,2
"RS Bopara ",2007,2015,120,118,35,35,35,0,0,2
"MJ Greatbatch ",1988,1996,84,84,35,35,34,1,0,2
"MG Johnson ",2005,2015,153,152,35,35,35,0,0,2
"L Klusener ",1996,2004,171,169,35,35,35,0,0,2
"Mohammad Ashraful ",2001,2013,177,177,35,35,35,0,0,2
"Waqar Younis ",1989,2003,262,259,35,35,35,0,0,2
"DM Bravo ",2009,2020,113,110,34,34,34,0,0,3
"HDPK Dharmasena ",1994,2004,141,140,34,34,34,0,0,2
"Nasir Hossain ",2011,2018,65,65,34,34,34,0,0,2
"PL Taylor ",1987,1992,83,83,34,34,34,0,0,2
"N Boje ",1995,2005,115,113,33,33,33,0,0,2
"RW Chakabva ",2008,2020,41,41,33,29,12,17,4,5
"CJ Chibhabha ",2005,2020,104,103,33,33,33,0,0,2
"NH Fairbrother ",1987,1999,75,75,33,33,33,0,0,3
"KM Jadhav ",2014,2020,73,72,33,33,33,0,0,3
"RS Kalpage ",1992,1999,86,86,33,33,33,0,0,3
"JM Kemp ",2001,2007,85,84,33,33,33,0,0,3
"Ramiz Raja ",1985,1997,198,193,33,33,33,0,0,2
"RR Singh ",1989,2001,136,135,33,33,33,0,0,2
"CJO Smith ",2006,2009,27,26,33,22,0,22,11,5
"Soumya Sarkar ",2014,2019,55,54,33,33,33,0,0,4
"Abdur Razzak ",2004,2014,153,153,32,32,32,0,0,2
"MM Ali ",2014,2020,102,99,32,32,32,0,0,3
"Ghulam Shabber ",2017,2019,23,23,32,30,0,30,2,4
"J Srinath ",1991,2003,229,227,32,32,32,0,0,2
"RW Taylor ",1973,1984,27,27,32,26,0,26,6,4
"TA Boult ",2012,2020,90,90,31,31,31,0,0,2
"DL Houghton ",1983,1997,63,63,31,29,19,10,2,4
"CK Kapugedera ",2006,2017,102,100,31,31,31,0,0,2
"AJ Lamb ",1982,1992,122,122,31,31,31,0,0,2
"SL Malinga ",2004,2019,226,220,31,31,31,0,0,2
"GR Marsh ",1986,1992,117,117,31,31,31,0,0,2
"M Morkel ",2007,2018,117,114,31,31,31,0,0,3
"JJ Roy ",2015,2020,87,85,31,31,31,0,0,2
"DR Smith ",2004,2015,105,103,31,31,31,0,0,2
"R Ashwin ",2010,2017,111,110,30,30,30,0,0,3
"RG de Alwis ",1983,1988,31,31,30,27,0,27,3,5
"J Garner ",1977,1987,98,98,30,30,30,0,0,3
"LK Germon ",1994,1997,37,37,30,21,0,21,9,4
"MA Holding ",1976,1987,102,102,30,30,30,0,0,3
"SS Karim ",1997,2000,34,34,30,27,0,27,3,4
"WK Lees ",1979,1983,31,31,30,28,0,28,2,4
"CS MacLeod ",2008,2019,66,65,30,30,30,0,0,4
"Mohammad Rizwan ",2015,2019,32,32,30,29,12,17,1,4
"Mushtaq Ahmed ",1989,2003,144,144,30,30,30,0,0,2
"M Ntini ",1998,2009,173,171,30,30,30,0,0,2
"CS Pandit ",1986,1992,36,36,30,15,0,15,15,4
"AU Rashid ",2009,2020,100,97,30,30,30,0,0,3
"PA Strang ",1994,2001,95,94,30,30,30,0,0,2
"Aftab Ahmed ",2004,2010,85,85,29,29,29,0,0,3
"TM Alderman ",1981,1991,65,65,29,29,29,0,0,3
"Alok Kapali ",2002,2011,69,69,29,29,29,0,0,2
"RD Berrington ",2008,2019,78,77,29,29,29,0,0,2
"PR Downton ",1977,1988,28,28,29,26,0,26,3,4
"AJ Hall ",1999,2007,88,87,29,29,29,0,0,2
"WW Hinds ",1999,2010,119,119,29,29,29,0,0,2
"DJ Hussey ",2008,2013,69,69,29,29,29,0,0,2
"R Mutumbami ",2014,2020,36,36,29,24,2,22,5,4
"GP Swann ",2000,2013,79,78,29,29,29,0,0,3
"DC Thomas ",2009,2013,21,21,29,23,0,23,6,3
"Ahmed Shehzad ",2009,2017,81,80,28,28,28,0,0,2
"PW Borren ",2006,2014,58,58,28,28,28,0,0,3
"JJ Crowe ",1983,1990,75,74,28,28,28,0,0,2
"AA Donald ",1991,2003,164,162,28,28,28,0,0,2
"GC Dyer ",1986,1988,23,23,28,24,0,24,4,4
"GJ Hopkins ",2004,2010,25,23,28,27,0,27,1,5
"Mohammad Rafique ",1995,2007,125,125,28,28,28,0,0,2
"TM Odoyo ",1996,2014,136,136,28,28,28,0,0,2
"RJ Peterson ",2002,2014,79,79,28,28,28,0,0,2
"LMP Simmons ",2006,2015,68,68,28,28,26,2,0,2
"DW Steyn ",2005,2019,125,124,28,28,28,0,0,2
"BA Young ",1990,1999,74,73,28,28,22,6,0,3
"KLT Arthurton ",1988,1999,105,104,27,27,27,0,0,2
"F Behardien ",2013,2018,59,58,27,27,27,0,0,2
"SCJ Broad ",2006,2016,121,121,27,27,27,0,0,2
"CRD Fernando ",2001,2012,147,146,27,27,27,0,0,3
"Sir RJ Hadlee ",1973,1990,115,113,27,27,27,0,0,2
"AD Hales ",2014,2019,70,68,27,27,27,0,0,2
"KJ Hughes ",1977,1985,97,96,27,27,27,0,0,2
"EC Joyce ",2006,2018,78,75,27,27,27,0,0,2
"B Kumar ",2012,2019,114,113,27,27,27,0,0,2
"Liton Das ",2015,2020,36,36,27,24,16,8,3,4
"CJ McDermott ",1985,1996,138,138,27,27,27,0,0,1
"MR Marsh ",2011,2020,57,57,27,27,27,0,0,4
"Mohammed Shami ",2013,2020,77,76,27,27,27,0,0,2
"M Prabhakar ",1984,1996,130,128,27,27,27,0,0,3
"MJ Santner ",2015,2020,72,71,27,27,27,0,0,2
"MA Starc ",2010,2020,91,91,27,27,27,0,0,2
"Wahab Riaz ",2008,2019,89,88,27,27,27,0,0,2
"CA Walsh ",1985,2000,205,204,27,27,27,0,0,1
"NW Bracken ",2001,2009,116,116,26,26,26,0,0,2
"PAJ DeFreitas ",1987,1997,103,103,26,26,26,0,0,2
"JEC Franklin ",2001,2013,110,109,26,26,26,0,0,2
"Habibul Bashar ",1995,2007,111,111,26,26,26,0,0,2
"Imran Nazir ",1999,2009,79,78,26,26,26,0,0,3
"DS Lehmann ",1996,2005,117,116,26,26,26,0,0,3
"MF Maharoof ",2004,2016,109,107,26,26,26,0,0,2
"LE Plunkett ",2005,2019,89,87,26,26,26,0,0,2
"AG Prince ",2002,2007,52,51,26,26,26,0,0,4
"RA Smith ",1988,1996,71,71,26,26,26,0,0,2
"GP Wickramasinghe ",1990,2002,134,134,26,26,26,0,0,2
"CB Wishart ",1996,2005,90,90,26,26,26,0,0,2
"B Zuiderent ",1996,2011,57,57,26,26,26,0,0,2
"W Barresi ",2010,2019,32,32,25,17,4,13,8,3
"D Gough ",1994,2006,159,157,25,25,25,0,0,1
"JR Hopes ",2005,2010,84,83,25,25,25,0,0,2
"Imran Tahir ",2011,2019,107,104,25,25,25,0,0,2
"DT Johnston ",2006,2013,67,65,25,25,25,0,0,2
"DJ Nash ",1992,2002,81,80,25,25,25,0,0,3
"DW Randall ",1976,1985,49,49,25,25,25,0,0,2
"PR Reiffel ",1992,1999,92,92,25,25,25,0,0,2
"Saeed Ajmal ",2008,2015,113,112,25,25,25,0,0,1
"MP Vaughan ",2001,2007,86,85,25,25,25,0,0,3
"Aaqib Javed ",1988,1998,163,159,24,24,24,0,0,1
"Asghar Afghan ",2009,2019,111,108,24,24,24,0,0,2
"V Dahiya ",2000,2001,19,19,24,19,0,19,5,3
"SS Dighe ",2000,2001,23,23,24,19,0,19,5,4
"NM Hauritz ",2002,2011,58,57,24,24,24,0,0,2
"S Viswanath ",1985,1988,22,22,24,17,0,17,7,5
"Wasim Raja ",1973,1985,54,52,24,24,24,0,0,2
"M Amarnath ",1975,1989,85,84,23,23,23,0,0,2
"SL Campbell ",1994,2001,90,90,23,23,23,0,0,3
"GS Chappell ",1971,1983,74,72,23,23,23,0,0,2
"DD Ebrahim ",2001,2005,82,82,23,23,23,0,0,2
"AH Jones ",1987,1995,87,87,23,23,23,0,0,2
"Junaid Siddique ",2007,2011,54,54,23,23,22,1,0,3
"GR Larsen ",1990,1999,121,121,23,23,23,0,0,1
"S Lee ",1995,2001,45,44,23,23,23,0,0,2
"SV Manjrekar ",1988,1996,74,74,23,23,23,0,0,2
"GRJ Matthews ",1984,1993,59,59,23,23,23,0,0,3
"PJ Moor ",2014,2019,49,48,23,22,6,16,1,4
"JDS Neesham ",2013,2020,63,63,23,23,23,0,0,2
"PA Nixon ",2007,2007,19,19,23,20,0,20,3,2
"DN Patel ",1987,1997,75,75,23,23,23,0,0,2
"SW Poynter ",2014,2019,21,21,23,22,3,19,1,4
"PL Symcox ",1993,1999,80,80,23,23,23,0,0,2
"TJ Zoehrer ",1986,1994,22,22,23,21,0,21,2,4
"Zulqarnain ",1985,1989,16,14,23,18,0,18,5,4
"Afsar Zazai ",2014,2017,17,16,22,20,0,20,2,3
"J Charles ",2012,2016,48,48,22,21,11,10,1,2
"MW Gatting ",1977,1993,92,92,22,22,22,0,0,2
"SM Gavaskar ",1974,1987,108,107,22,22,22,0,0,4
"AF Giles ",1997,2005,62,62,22,22,22,0,0,3
"SE Marsh ",2008,2019,73,73,22,22,22,0,0,2
"PL Mommsen ",2010,2017,44,43,22,22,22,0,0,2
"C Munro ",2013,2019,57,57,22,22,22,0,0,2
"SP O'Donnell ",1985,1991,87,87,22,22,22,0,0,2
"HH Pandya ",2016,2019,54,53,22,22,22,0,0,2
"K Rabada ",2015,2019,75,73,22,22,22,0,0,2
"Rashid Khan ",2015,2019,71,68,22,22,22,0,0,3
"RR Rossouw ",2014,2016,36,35,22,22,22,0,0,4
"MN Waller ",2009,2018,79,79,22,22,22,0,0,1
"RGD Willis ",1973,1984,64,64,22,22,22,0,0,2
"UT Yadav ",2010,2018,75,73,22,22,22,0,0,3
"Abdul Qadir ",1983,1993,104,102,21,21,21,0,0,2
"DL Bairstow ",1979,1984,21,21,21,17,0,17,4,3
"Fakhar Zaman ",2017,2019,46,45,21,21,21,0,0,2
"JP Faulkner ",2013,2017,69,69,21,21,21,0,0,1
"Imrul Kayes ",2008,2018,78,78,21,21,21,0,0,2
"ND McKenzie ",2000,2009,64,64,21,21,21,0,0,3
"Manzoor Elahi ",1984,1995,54,54,21,21,21,0,0,2
"AF Milne ",2012,2017,40,39,21,21,21,0,0,3
"D Mongia ",2001,2007,57,56,21,21,21,0,0,3
"TM Moody ",1987,1999,76,76,21,21,21,0,0,2
"Mudassar Nazar ",1977,1989,122,119,21,21,21,0,0,2
"A Nel ",2001,2008,79,77,21,21,21,0,0,2
"IK Pathan ",2004,2012,120,118,21,21,21,0,0,1
"MSK Prasad ",1998,1999,17,17,21,14,0,14,7,5
"KAJ Roach ",2008,2019,92,90,21,21,21,0,0,2
"Samiullah Shinwari ",2009,2019,84,84,21,21,21,0,0,2
"OA Shah ",2001,2009,71,71,21,21,21,0,0,2
"RV Uthappa ",2006,2015,46,44,21,19,15,4,2,3
"AR White ",2006,2014,61,61,21,21,21,0,0,2
"AR Whittall ",1996,2000,63,63,21,21,21,0,0,3
"DJ Willey ",2015,2019,46,45,21,21,21,0,0,2
"Ashraf Ali ",1980,1985,16,16,20,17,0,17,3,3
"A Balbirnie ",2010,2020,67,65,20,20,20,0,0,4
"GB Brent ",1996,2008,70,70,20,20,20,0,0,2
"TT Bresnan ",2006,2015,85,84,20,20,20,0,0,2
"AF Buurman ",2007,2011,17,17,20,17,2,15,3,3
"CK Coventry ",2003,2015,39,39,20,19,19,0,1,1
"DN Crookes ",1994,2000,32,32,20,20,20,0,0,2
"DM de Silva ",2016,2020,45,45,20,20,20,0,0,2
"M Dillon ",1997,2005,108,107,20,20,20,0,0,2
"JS Foster ",2001,2002,11,11,20,13,0,13,7,3
"MW Goodwin ",1998,2000,71,71,20,20,20,0,0,2
"JK Kamande ",1999,2011,86,86,20,20,20,0,0,2
"H Klaasen ",2018,2020,17,17,20,17,6,11,3,4
"CC Lewis ",1990,1998,53,53,20,20,20,0,0,2
"DA Minors ",2006,2007,20,20,20,16,4,12,4,3
"RS Morton ",2002,2010,56,55,20,20,20,0,0,3
"Rubel Hossain ",2009,2019,101,100,20,20,20,0,0,2
"Salman Butt ",2004,2010,78,77,20,20,20,0,0,2
"Shoaib Akhtar ",1998,2011,163,162,20,20,20,0,0,2
"NS Sidhu ",1987,1998,136,135,20,20,20,0,0,2
"LPC Silva ",1999,2011,75,73,20,20,20,0,0,3
"SAR Silva ",1984,1985,20,20,20,17,0,17,3,3
"JE Taylor ",2003,2017,90,88,20,20,20,0,0,2
"DR Tuffey ",2000,2010,94,92,20,20,20,0,0,3
"BJ Watling ",2010,2018,28,28,20,20,6,14,0,3
"Akram Raza ",1989,1995,49,49,19,19,19,0,0,2
"AJ Bichel ",1997,2004,67,66,19,19,19,0,0,2
"JG Bracewell ",1983,1990,53,52,19,19,19,0,0,3
"BL Cairns ",1974,1985,78,77,19,19,19,0,0,2
"EJ Chatfield ",1979,1989,114,112,19,19,19,0,0,2
"SS Cottrell ",2015,2020,35,33,19,19,19,0,0,3
"XJ Doherty ",2010,2015,60,60,19,19,19,0,0,2
"JE Emburey ",1980,1993,61,61,19,19,19,0,0,2
"JM How ",2005,2011,41,40,19,19,19,0,0,4
"NC Johnson ",1998,2000,48,48,19,19,19,0,0,2
"CJ Jordan ",2013,2020,34,34,19,19,19,0,0,2
"SB Joshi ",1996,2001,69,68,19,19,19,0,0,2
"RAS Lakmal ",2009,2019,85,83,19,19,19,0,0,1
"AR McBrine ",2014,2020,45,44,19,19,19,0,0,3
"Mohammad Sami ",2001,2015,87,86,19,19,19,0,0,2
"JF Mooney ",2006,2015,64,62,19,19,19,0,0,2
"DK Morrison ",1987,1996,96,96,19,19,19,0,0,2
"Naeem Islam ",2008,2014,59,59,19,19,19,0,0,2
"Nawroz Mangal ",2009,2016,49,49,19,19,19,0,0,2
"CJ Nevin ",2000,2003,37,36,19,16,2,14,3,3
"Rahmat Shah ",2013,2019,73,70,19,19,19,0,0,2
"SMSM Senanayake ",2012,2015,49,48,19,19,19,0,0,3
"I Sharma ",2007,2016,80,78,19,19,19,0,0,1
"MC Snedden ",1980,1990,93,92,19,19,19,0,0,1
"AO Suji ",1996,2008,60,60,19,19,19,0,0,2
"V Yadav ",1992,1994,19,19,19,12,0,12,7,3
"Asif Mujtaba ",1986,1996,66,66,18,18,18,0,0,3
"AR Cusack ",2007,2015,59,55,18,18,18,0,0,2
"PG Fulton ",2004,2009,49,48,18,18,18,0,0,2
"IJ Gould ",1983,1983,18,18,18,15,0,15,3,3
"SO Hetmyer ",2017,2020,45,43,18,18,15,3,0,3
"AC Hudson ",1991,1997,89,88,18,18,18,0,0,2
"AN Kervezee ",2006,2012,39,39,18,18,18,0,0,3
"GF Lawson ",1980,1989,79,79,18,18,18,0,0,2
"MA Leask ",2014,2019,34,34,18,18,18,0,0,3
"S Madan Lal ",1974,1987,67,65,18,18,18,0,0,2
"RS Madugalle ",1979,1988,63,63,18,18,18,0,0,2
"JP Maher ",1998,2003,26,26,18,18,10,8,0,3
"Maninder Singh ",1983,1993,59,58,18,18,18,0,0,2
"HJH Marshall ",2003,2007,66,65,18,18,18,0,0,3
"NO Miller ",2008,2018,50,48,18,18,18,0,0,3
"A Nehra ",2001,2011,120,120,18,18,18,0,0,2
"HM Nicholls ",2015,2020,49,48,18,18,18,0,0,2
"RR Patel ",2008,2014,39,39,18,18,18,0,0,2
"Raqibul Hasan ",2008,2011,55,55,18,18,18,0,0,2
"WP Saha ",2010,2014,9,8,18,17,0,17,1,4
"SA Thomson ",1990,1996,56,56,18,18,18,0,0,2
"MA Vermeulen ",2000,2009,43,43,18,18,18,0,0,3
"DP Viljoen ",1997,2001,53,53,18,18,18,0,0,2
"SC Williams ",1994,1999,57,57,18,18,18,0,0,3
"LJ Wright ",2007,2014,50,50,18,18,18,0,0,2
"Ahmed Raza ",2014,2020,31,31,17,17,17,0,0,3
"JJ Bumrah ",2016,2020,64,64,17,17,17,0,0,2
"JM Davison ",2003,2011,32,32,17,17,17,0,0,2
"GD Elliott ",2008,2016,83,83,17,17,17,0,0,2
"TJ Friend ",2000,2004,51,51,17,17,17,0,0,2
"Haris Sohail ",2013,2019,41,40,17,17,17,0,0,2
"IJ Harvey ",1997,2004,73,72,17,17,17,0,0,2
"MJ Henry ",2014,2019,52,50,17,17,17,0,0,2
"Khaled Mahmud ",1998,2006,77,77,17,17,17,0,0,2
"E Lewis ",2016,2020,51,49,17,17,17,0,0,2
"EB McSweeney ",1986,1987,16,15,17,14,0,14,3,3
"PJ Ongondo ",1999,2011,79,79,17,17,17,0,0,2
"YK Pathan ",2008,2012,57,56,17,17,17,0,0,3
"RW Price ",2002,2012,102,102,17,17,17,0,0,2
"WB Rankin ",2007,2020,75,73,17,17,17,0,0,2
"AT Rayudu ",2013,2019,55,53,17,17,17,0,0,2
"CJ Richards ",1981,1988,22,22,17,16,0,16,1,3
"TT Samaraweera ",1998,2011,53,51,17,17,17,0,0,2
"MS Sinclair ",2000,2009,54,54,17,17,15,2,0,2
"Umar Gul ",2003,2016,130,128,17,17,17,0,0,2
"GM Wood ",1978,1989,83,80,17,17,17,0,0,2
"Aamer Malik ",1988,1994,24,24,16,13,3,10,3,2
"CWJ Athey ",1980,1988,31,31,16,16,16,0,0,3
"JJ Atkinson ",2008,2017,9,9,16,10,0,10,6,4
"WKM Benjamin ",1986,1995,85,85,16,16,16,0,0,1
"N Chopra ",1998,2000,39,38,16,16,16,0,0,2
"KJ Coetzer ",2008,2019,59,58,16,16,16,0,0,2
"PJ Cummins ",2011,2020,64,64,16,16,16,0,0,2
"Dawlat Zadran ",2011,2019,82,80,16,16,16,0,0,2
"RL Dias ",1979,1987,58,58,16,16,16,0,0,2
"BN French ",1985,1988,13,13,16,13,0,13,3,3
"BJ Hodge ",2005,2007,25,25,16,16,16,0,0,2
"GP Howarth ",1975,1985,70,69,16,16,16,0,0,2
"APE Knott ",1971,1977,20,19,16,15,0,15,1,4
"T Mishra ",2006,2013,42,42,16,16,16,0,0,2
"DA Murray ",1973,1981,10,10,16,16,0,16,0,3
"TJ Murtagh ",2012,2019,58,57,16,16,16,0,0,1
"Naved-ul-Hasan ",2003,2010,74,72,16,16,16,0,0,2
"A Ratra ",2002,2002,12,12,16,11,0,11,5,3
"GJ Rennie ",1996,2003,40,40,16,16,16,0,0,2
"RD Shah ",1998,2007,56,56,16,16,16,0,0,2
"VS Solanki ",2000,2006,51,50,16,16,16,0,0,2
"A Vala ",2014,2019,27,27,16,16,16,0,0,3
"Zaheer Abbas ",1974,1985,62,60,16,16,16,0,0,2
"Anil Dalpat ",1984,1986,15,14,15,13,0,13,2,3
"MA Atherton ",1990,1998,54,54,15,15,15,0,0,2
"Basit Ali ",1993,1996,50,49,15,15,15,0,0,2
"SE Bond ",2002,2010,82,80,15,15,15,0,0,2
"YS Chahal ",2016,2020,52,52,15,15,15,0,0,2
"SKL de Silva ",1997,1997,11,11,15,9,0,9,6,3
"PS de Villiers ",1992,1997,83,82,15,15,15,0,0,2
"ST Finn ",2011,2017,69,67,15,15,15,0,0,2
"DT Hondo ",2001,2005,56,56,15,15,15,0,0,1
"VG Kambli ",1991,2000,104,101,15,15,15,0,0,1
"MD Marshall ",1980,1992,136,134,15,15,15,0,0,2
"BAW Mendis ",2008,2015,87,85,15,15,15,0,0,2
"JA Morkel ",2004,2012,58,58,15,15,15,0,0,2
"Noor Ali Zadran ",2009,2019,51,49,15,15,15,0,0,2
"AR Nurse ",2016,2019,54,52,15,15,15,0,0,3
"AA Obanda ",2007,2014,49,49,15,15,15,0,0,2
"JL Ontong ",2001,2012,28,27,15,15,15,0,0,2
"AR Patel ",2014,2017,38,36,15,15,15,0,0,2
"KL Rahul ",2016,2020,32,32,15,13,8,5,2,3
"Rizwan Cheema ",2008,2013,33,32,15,15,15,0,0,2
"Rohan Mustafa ",2014,2020,37,37,15,15,15,0,0,2
"JD Ryder ",2008,2014,48,48,15,15,15,0,0,2
"Sohail Tanvir ",2007,2014,62,60,15,15,15,0,0,2
"CM Spearman ",1995,2001,51,51,15,15,15,0,0,1
"BC Strang ",1995,2001,49,48,15,15,15,0,0,2
"HA Varaiya ",2006,2014,63,63,15,15,15,0,0,2
"KJ Wadsworth ",1973,1976,13,13,15,13,0,13,2,3
"CD Wallace ",2012,2019,28,28,15,13,8,5,2,4
"Asad Shafiq ",2010,2017,60,59,14,14,14,0,0,2
"EAE Baptiste ",1983,1990,43,43,14,14,14,0,0,2
"AC Cummins ",1991,2007,76,75,14,14,14,0,0,2
"A Dananjaya ",2012,2019,36,35,14,14,14,0,0,2
"C de Grandhomme ",2012,2020,42,42,14,14,14,0,0,2
"DW Fleming ",1994,2001,88,88,14,14,14,0,0,1
"HA Gomes ",1978,1987,83,83,14,14,14,0,0,1
"PSP Handscomb ",2017,2019,22,22,14,14,9,5,0,3
"HMRKB Herath ",2004,2015,71,69,14,14,14,0,0,2
"Imran Farhat ",2001,2013,58,58,14,14,14,0,0,1
"HH Kanitkar ",1997,2000,34,34,14,14,14,0,0,2
"Mansoor Akhtar ",1980,1990,41,40,14,14,14,0,0,2
"LRD Mendis ",1975,1989,79,79,14,14,14,0,0,2
"AA Mulla ",2006,2009,24,24,14,9,5,4,5,2
"SP Narine ",2011,2016,65,65,14,14,14,0,0,2
"KOA Powell ",2009,2018,46,45,14,14,14,0,0,2
"R Powell ",2016,2018,34,33,14,14,14,0,0,2
"R Rampaul ",2003,2015,92,89,14,14,14,0,0,2
"JR Ratnayeke ",1982,1990,78,78,14,14,14,0,0,2
"Shafiqullah ",2009,2018,24,24,14,11,3,8,3,2
"JC Tredwell ",2010,2015,45,44,14,14,14,0,0,2
"IJL Trott ",2009,2013,68,66,14,14,14,0,0,2
"LJ Tucker ",2019,2020,8,8,14,13,1,12,1,3
"RR Watson ",2006,2010,35,34,14,14,14,0,0,2
"Yasir Hameed ",2003,2007,56,56,14,14,14,0,0,2
"Aminul Islam ",1988,2002,39,39,13,13,13,0,0,2
"HK Badani ",2000,2004,40,40,13,13,13,0,0,2
"B Bhandari ",2019,2020,7,7,13,12,0,12,1,4
"SW Billings ",2015,2018,15,15,13,13,9,4,0,2
"PB Dassanayake ",1993,1994,16,16,13,9,0,9,4,2
"ALF de Mel ",1982,1987,57,57,13,13,13,0,0,2
"Dhiman Ghosh ",2008,2008,14,14,13,9,0,9,4,4
"Farhad Reza ",2006,2011,34,34,13,13,13,0,0,2
"DA Gunawardene ",1998,2006,61,61,13,13,13,0,0,2
"JR Hazlewood ",2010,2020,48,48,13,13,13,0,0,2
"RR Hendricks ",2018,2020,21,20,13,13,13,0,0,3
"AJ Hollioake ",1996,1999,35,35,13,13,13,0,0,3
"MS Kasprowicz ",1995,2005,43,42,13,13,13,0,0,2
"SM Katich ",2001,2006,45,45,13,13,13,0,0,1
"UT Khawaja ",2013,2019,40,40,13,13,13,0,0,2
"NFI McCallum ",2006,2011,43,42,13,13,13,0,0,2
"R McLaren ",2009,2014,54,52,13,13,13,0,0,1
"Mehidy Hasan Miraz ",2017,2020,41,40,13,13,13,0,0,3
"BMAJ Mendis ",2010,2019,58,56,13,13,13,0,0,2
"Mohsin Khan ",1977,1986,75,73,13,13,13,0,0,2
"Mosaddek Hossain ",2016,2019,35,34,13,13,13,0,0,2
"Nasir Jamshed ",2008,2015,48,48,13,13,13,0,0,2
"HK Olonga ",1995,2003,50,50,13,13,13,0,0,2
"JS Patel ",2005,2017,43,42,13,13,13,0,0,1
"AL Phehlukwayo ",2016,2020,58,56,13,13,13,0,0,2
"DBL Powell ",2002,2009,55,55,13,13,13,0,0,2
"Shahriar Nafees ",2005,2011,75,75,13,13,13,0,0,2
"Shoaib Mohammad ",1984,1993,63,62,13,13,13,0,0,2
"RP Singh ",2005,2011,58,58,13,13,13,0,0,1
"DS Smith ",2003,2013,47,46,13,13,13,0,0,3
"RN ten Doeschate ",2006,2011,33,33,13,13,13,0,0,2
"GM Turner ",1973,1983,41,41,13,13,13,0,0,2
"DNT Zoysa ",1997,2007,95,94,13,13,13,0,0,2
"Akshay Homraj ",2019,2020,8,8,12,12,0,12,0,4
"Amjad Ali ",2008,2015,17,17,12,11,7,4,1,3
"PK Amre ",1991,1994,37,36,12,12,12,0,0,2
"RMH Binny ",1980,1987,72,70,12,12,12,0,0,2
"IR Bishop ",1988,1997,84,83,12,12,12,0,0,1
"DE Bollinger ",2009,2011,39,39,12,12,12,0,0,1
"JM Brearley ",1977,1980,25,25,12,12,12,0,0,2
"C Carter ",2015,2018,11,11,12,10,1,9,2,3
"CD Collymore ",1999,2007,84,83,12,12,12,0,0,2
"TLW Cooper ",2010,2013,23,23,12,12,12,0,0,2
"KM Dabengwa ",2005,2010,37,37,12,12,12,0,0,2
"JWM Dalrymple ",2006,2007,27,27,12,12,12,0,0,2
"KSC de Silva ",1996,2000,38,37,12,12,12,0,0,2
"J Dyson ",1980,1983,29,29,12,12,12,0,0,3
"BA Edgar ",1978,1986,64,63,12,12,12,0,0,2
"CN Evans ",1992,2002,53,52,12,12,12,0,0,2
"NA Foster ",1984,1989,48,48,12,12,12,0,0,2
"Gulbadin Naib ",2011,2019,65,63,12,12,12,0,0,1
"MD Gunathilaka ",2015,2019,38,37,12,12,12,0,0,2
"Hasan Ali ",2016,2019,53,52,12,12,12,0,0,2
"TM Head ",2016,2018,42,42,12,12,12,0,0,2
"MJ Horne ",1997,2002,50,49,12,12,12,0,0,2
"Imad Wasim ",2015,2019,53,52,12,12,12,0,0,1
"CA Ingram ",2010,2013,31,31,12,12,12,0,0,2
"Javed Omar ",1995,2007,59,59,12,12,12,0,0,2
"SG Law ",1994,1999,54,54,12,12,12,0,0,2
"DA Marillier ",2000,2003,48,48,12,12,12,0,0,2
"AK Markram ",2017,2019,26,25,12,12,12,0,0,3
"XM Marshall ",2005,2020,37,36,12,12,12,0,0,2
"T Maruma ",2007,2019,21,21,12,12,12,0,0,3
"SF Mire ",2014,2019,47,47,12,12,12,0,0,1
"HS Modi ",1996,2006,63,63,12,12,12,0,0,2
"J Mubarak ",2002,2013,40,40,12,12,12,0,0,2
"Mustafizur Rahman ",2015,2020,58,57,12,12,12,0,0,2
"Nadeem Ahmed ",2004,2018,25,25,12,12,12,0,0,2
"MO Odumbe ",1996,2003,61,61,12,12,12,0,0,2
"JM Parker ",1974,1981,24,24,12,11,11,0,1,3
"WD Parnell ",2009,2017,65,62,12,12,12,0,0,2
"DA Reeve ",1991,1996,29,29,12,12,12,0,0,3
"JA Rennie ",1993,2000,44,44,12,12,12,0,0,2
"PM Seelaar ",2006,2019,41,41,12,12,12,0,0,2
"Shaiman Anwar ",2014,2019,40,40,12,12,12,0,0,2
"MP Stoinis ",2015,2019,41,41,12,12,12,0,0,1
"C White ",1994,2003,51,50,12,12,12,0,0,1
"CJ Anderson ",2013,2017,49,48,11,11,11,0,0,2
"Babar Hayat ",2014,2018,22,22,11,11,11,0,0,2
"L Balaji ",2002,2009,30,30,11,11,11,0,0,2
"AM Blignaut ",1999,2010,54,54,11,11,11,0,0,2
"AC Botha ",2006,2011,42,40,11,11,11,0,0,2
"EA Brandes ",1987,1999,59,59,11,11,11,0,0,1
"CR Brathwaite ",2011,2019,44,42,11,11,11,0,0,1
"RL Chase ",2017,2020,30,28,11,11,11,0,0,2
"R Clarke ",2003,2006,20,20,11,11,11,0,0,3
"RDB Croft ",1996,2001,50,49,11,11,11,0,0,1
"AC Dale ",1997,2000,30,30,11,11,11,0,0,1
"J Edness ",2007,2008,11,11,11,7,0,7,4,3
"D Ganga ",1999,2006,35,35,11,11,11,0,0,2
"DW Hookes ",1977,1986,39,37,11,11,11,0,0,2
"KM Jarvis ",2009,2019,49,49,11,11,11,0,0,2
"Javed Ahmadi ",2010,2019,44,41,11,11,11,0,0,1
"PN Kirsten ",1991,1994,40,40,11,11,11,0,0,2
"P Kumar ",2007,2012,68,67,11,11,11,0,0,2
"CK Langeveldt ",2001,2010,72,71,11,11,11,0,0,1
"RT Latham ",1990,1994,33,33,11,11,11,0,0,2
"Mohammad Irfan ",2010,2016,60,60,11,11,11,0,0,2
"CB Mpofu ",2004,2020,84,83,11,11,11,0,0,1
"HG Munsey ",2017,2019,25,25,11,11,11,0,0,2
"BA Murphy ",2000,2003,31,31,11,11,11,0,0,2
"D Murphy ",2013,2013,8,8,11,8,0,8,3,5
"TK Musakanda ",2016,2018,15,15,11,11,11,0,0,2
"P Mustard ",2007,2008,10,10,11,9,0,9,2,2
"F Mutizwa ",2009,2011,17,17,11,9,1,8,2,3
"RJ Nicol ",2011,2013,22,22,11,11,11,0,0,2
"SB O'Connor ",1997,2000,38,38,11,11,11,0,0,2
"H Osinde ",2006,2013,42,41,11,11,11,0,0,2
"MM Patel ",2006,2011,70,68,11,11,11,0,0,2
"SM Patil ",1980,1986,45,44,11,11,11,0,0,2
"SP Patil ",2014,2015,13,13,11,8,0,8,3,3
"DR Pringle ",1982,1993,44,44,11,11,11,0,0,2
"CPH Ramanayake ",1986,1995,62,62,11,11,11,0,0,2
"RJ Ratnayake ",1982,1993,70,70,11,11,11,0,0,2
"SJ Rhodes ",1989,1995,9,9,11,9,0,9,2,4
"SJ Rixon ",1978,1985,6,6,11,9,0,9,2,4
"JA Rudolph ",2003,2006,45,45,11,11,11,0,0,2
"AD Russell ",2011,2019,56,56,11,11,11,0,0,1
"Sanwar Hossain ",1998,2003,27,27,11,11,11,0,0,2
"SM Sharif ",2011,2019,44,44,11,11,11,0,0,2
"MA Suji ",1996,2006,64,64,11,11,11,0,0,2
"Tahir Naqqash ",1980,1985,40,38,11,11,11,0,0,2
"TP Ura ",2014,2019,26,26,11,11,11,0,0,2
"DLS van Bunge ",2002,2013,37,37,11,11,11,0,0,2
"MN van Wyk ",2003,2015,17,17,11,10,1,9,1,4
"PA Wallace ",1991,2000,33,32,11,11,11,0,0,2
"MR Whitney ",1983,1993,38,38,11,11,11,0,0,3
"MA Wood ",2015,2019,51,50,11,11,11,0,0,2
"A Zampa ",2016,2020,55,55,11,11,11,0,0,1
"Amir Hamza ",2012,2017,31,31,10,10,10,0,0,2
"Anamul Haque ",2012,2019,38,38,10,10,4,6,0,3
"SD Anurasiri ",1986,1994,45,45,10,10,10,0,0,2
"Arshad Khan ",1993,2006,58,57,10,10,10,0,0,2
"SFAF Bacchus ",1978,1983,29,29,10,10,10,0,0,2
"BC Broad ",1987,1988,34,34,10,10,10,0,0,1
"RK Chauhan ",1993,1997,35,34,10,10,10,0,0,1
"DT Christian ",2012,2014,19,19,10,10,10,0,0,2
"SR Clark ",2005,2009,39,39,10,10,10,0,0,2
"JH Davey ",2010,2019,31,30,10,10,10,0,0,2
"SB Doull ",1992,2000,42,42,10,10,10,0,0,2
"Fawad Alam ",2007,2015,38,38,10,10,10,0,0,2
"LH Ferguson ",2016,2020,37,37,10,10,10,0,0,1
"JN Gillespie ",1996,2005,97,97,10,10,10,0,0,1
"DAS Gunaratne ",2016,2019,31,30,10,10,10,0,0,2
"RM Haq ",2006,2015,54,52,10,10,10,0,0,2
"SJ Harmison ",2002,2009,58,58,10,10,10,0,0,1
"BW Hilfenhaus ",2007,2012,25,25,10,10,10,0,0,2
"TG Hogan ",1983,1984,16,15,10,10,10,0,0,2
"Iftikhar Anjum ",2004,2010,62,61,10,10,10,0,0,3
"Ihsanullah ",2017,2018,16,16,10,10,10,0,0,3
"LM Jongwe ",2014,2016,22,22,10,10,10,0,0,3
"M Kartik ",2002,2007,37,37,10,10,10,0,0,1
"FDM Karunaratne ",2011,2020,31,31,10,10,10,0,0,1
"R Lamba ",1986,1989,32,32,10,10,10,0,0,1
"RDM Leverock ",2006,2009,32,32,10,10,10,0,0,2
"DK Lillee ",1972,1983,63,63,10,10,10,0,0,2
"DR Lockhart ",2006,2010,14,14,10,10,1,9,0,3
"CR Matthews ",1991,1997,56,55,10,10,10,0,0,2
"BJ McCarthy ",2016,2020,30,30,10,10,10,0,0,2
"Mohammad Salman ",2011,2011,7,7,10,8,0,8,2,4
"DS Mohanty ",1997,2001,45,44,10,10,10,0,0,2
"Muhammad Usman ",2016,2020,33,33,10,10,10,0,0,3
"KMA Paul ",2018,2020,19,19,10,10,10,0,0,2
"Saleem Elahi ",1995,2004,48,47,10,10,10,0,0,2
"Shabbir Ahmed ",1999,2005,32,32,10,10,10,0,0,2
"Simi Singh ",2017,2020,18,18,10,10,10,0,0,2
"Tauseef Ahmed ",1982,1990,70,68,10,10,10,0,0,1
"KL Tucker ",2006,2007,12,12,10,9,1,8,1,4
"AC Waller ",1987,1997,39,38,10,10,10,0,0,2
"KD Walters ",1971,1981,28,28,10,10,10,0,0,3
"CAK Walton ",2009,2017,9,9,10,9,3,6,1,4
"MH Yardy ",2006,2011,28,28,10,10,10,0,0,2
"Yashpal Sharma ",1978,1985,42,42,10,10,10,0,0,1
"CJA Amini ",2014,2019,15,15,9,9,9,0,0,1
"HS Baidwan ",2008,2014,32,32,9,9,9,0,0,1
"HMCM Bandara ",2006,2010,31,30,9,9,9,0,0,3
"SJ Benn ",2008,2016,47,46,9,9,9,0,0,1
"NT Broom ",2009,2017,39,39,9,9,9,0,0,2
"AR Caddick ",1993,2003,54,53,9,9,9,0,0,2
"LOB Cann ",2006,2009,26,26,9,9,9,0,0,2
"PP Chawla ",2007,2011,25,25,9,9,9,0,0,3
"N Deonarine ",2005,2015,31,31,9,9,9,0,0,2
"SI de Saram ",1999,2001,15,15,9,9,9,0,0,2
"MA Ealham ",1996,2001,64,63,9,9,9,0,0,1
"S Elworthy ",1998,2002,39,38,9,9,9,0,0,3
"ZE Green ",2019,2020,8,8,9,7,0,7,2,5
"Hashmatullah Shahidi ",2013,2019,39,38,9,9,9,0,0,1
"AS Joseph ",2016,2020,28,27,9,9,9,0,0,2
"IA Karim ",2011,2014,9,9,9,8,3,5,1,2
"CM Kuggeleijn ",1988,1989,16,16,9,9,9,0,0,2
"NC McGarrell ",1998,2001,17,17,9,9,9,0,0,2
"RD McCann ",2010,2010,8,8,9,9,0,9,0,3
"SS McKechnie ",2017,2018,8,8,9,8,1,7,1,4
"Mohammad Wasim ",1996,2000,25,25,9,9,9,0,0,2
"CH Morris ",2013,2019,42,40,9,9,9,0,0,1
"T Mupariwa ",2004,2016,40,40,9,9,9,0,0,1
"Nizakat Khan ",2014,2018,20,20,9,9,9,0,0,2
"SJ Palframan ",1996,1996,7,7,9,9,0,9,0,3
"RR Pant ",2018,2020,16,16,9,8,4,4,1,2
"T Panyangara ",2004,2016,65,65,9,9,9,0,0,2
"BP Patterson ",1986,1993,59,58,9,9,9,0,0,1
"N Pooran ",2019,2020,25,24,9,8,7,1,1,2
"AD Poynter ",2008,2014,19,18,9,9,9,0,0,2
"Rajin Saleh ",2003,2006,43,43,9,9,9,0,0,2
"GM Ritchie ",1982,1987,44,44,9,9,9,0,0,2
"AM Samad ",2003,2009,27,26,9,9,9,0,0,2
"MJ Slater ",1993,1997,42,42,9,9,9,0,0,2
"RS Sodhi ",2000,2002,18,18,9,9,9,0,0,2
"Sohaib Maqsood ",2013,2016,26,26,9,9,9,0,0,2
"Sohrawordi Shuvo ",2010,2011,17,17,9,9,9,0,0,2
"Suraj Kumar ",2019,2020,11,11,9,9,0,9,0,2
"Taufeeq Umar ",2001,2011,22,22,9,9,9,0,0,1
"JR Thomson ",1975,1985,50,50,9,9,9,0,0,2
"LL Tsotsobe ",2009,2013,61,60,9,9,9,0,0,2
"JJ Tucker ",2006,2009,26,26,9,9,9,0,0,2
"HE van der Dussen ",2019,2020,21,19,9,9,9,0,0,2
"JNT Vare ",2014,2018,9,9,9,6,0,6,3,3
"M Vijay ",2010,2015,17,17,9,9,9,0,0,2
"W Watson ",1986,1994,61,61,9,9,9,0,0,1
"AR Adams ",2001,2007,42,41,8,8,8,0,0,2
"Akram Khan ",1988,2003,44,44,8,8,8,0,0,2
"Amjad Javed ",2008,2017,15,15,8,8,8,0,0,1
"Azhar Ali ",2011,2018,53,52,8,8,8,0,0,1
"GS Ballance ",2013,2015,16,16,8,8,8,0,0,2
"D Bau ",2016,2017,10,10,8,6,1,5,2,3
"S Bau ",2016,2019,21,21,8,8,8,0,0,1
"ID Blackwell ",2002,2006,34,34,8,8,8,0,0,2
"JAR Blain ",1999,2009,33,32,8,8,8,0,0,1
"MG Burgess ",1973,1981,26,26,8,8,8,0,0,2
"RP Burl ",2017,2019,18,18,8,8,8,0,0,2
"IG Butler ",2002,2010,26,25,8,8,8,0,0,2
"TM Chappell ",1980,1983,20,20,8,8,8,0,0,2
"FRJ Coleman ",2013,2015,16,15,8,8,8,0,0,3
"PT Collins ",1999,2005,30,30,8,8,8,0,0,2
"MD Dai ",2014,2018,18,18,8,8,8,0,0,2
"SM Davies ",2009,2011,8,8,8,8,0,8,0,2
"S Dhaniram ",2006,2010,44,43,8,8,8,0,0,1
"Enamul Haque jnr ",2005,2009,10,10,8,8,8,0,0,2
"AC Evans ",2009,2019,36,35,8,8,8,0,0,1
"ADS Fletcher ",2008,2016,25,25,8,5,3,2,3,3
"Hannan Sarkar ",2002,2004,20,20,8,8,6,2,0,2
"RM Hogg ",1979,1985,71,69,8,8,8,0,0,1
"RIC Holder ",1993,1997,37,37,8,8,8,0,0,3
"RK Illingworth ",1991,1996,25,25,8,8,8,0,0,2
"SS Iyer ",2017,2020,18,18,8,8,8,0,0,2
"BP Julian ",1993,1999,25,25,8,8,8,0,0,2
"Junaid Khan ",2011,2019,76,76,8,8,8,0,0,1
"AI Kallicharran ",1973,1981,31,31,8,8,8,0,0,2
"SC Khanna ",1979,1984,10,9,8,4,0,4,4,3
"GF Labrooy ",1986,1992,44,44,8,8,8,0,0,1
"W Larkins ",1979,1991,25,25,8,8,8,0,0,1
"NAM McLean ",1996,2003,45,45,8,8,8,0,0,2
"Manjural Islam ",1999,2003,34,34,8,8,8,0,0,1
"VJ Marks ",1980,1988,34,34,8,8,8,0,0,1
"Mirwais Ashraf ",2009,2016,46,45,8,8,8,0,0,2
"Mohammad Akram ",1995,2000,23,21,8,8,8,0,0,2
"Mohammad Amir ",2009,2019,61,60,8,8,8,0,0,2
"S Mukuddem ",2006,2007,20,20,8,8,8,0,0,1
"AD Mullally ",1996,2001,50,49,8,8,8,0,0,2
"L Ngidi ",2018,2020,26,26,8,8,8,0,0,2
"CM Old ",1973,1981,32,32,8,8,8,0,0,2
"DR Parry ",1978,1980,6,6,8,8,8,0,0,2
"KR Pushpakumara ",1994,1999,31,31,8,8,8,0,0,3
"EC Rainsford ",2004,2010,39,39,8,8,8,0,0,2
"SLV Raju ",1990,1996,53,52,8,8,8,0,0,1
"MR Ramprakash ",1991,2001,18,18,8,8,8,0,0,2
"MJR Rindel ",1994,1999,22,22,8,8,8,0,0,2
"IH Romaine ",2006,2009,35,35,8,8,8,0,0,2
"PADLR Sandakan ",2016,2020,24,24,8,8,8,0,0,2
"Sarfraz Nawaz ",1973,1984,45,45,8,8,8,0,0,1
"TL Seifert ",2019,2019,3,3,8,7,0,7,1,4
"Shadab Khan ",2017,2019,43,43,8,8,8,0,0,1
"Shafiul Islam ",2010,2020,60,60,8,8,8,0,0,2
"L Siaka ",2014,2019,25,25,8,8,8,0,0,2
"SB Smith ",1983,1985,28,27,8,8,8,0,0,1
"IS Sodhi ",2015,2020,33,32,8,8,8,0,0,2
"Syed Rasel ",2005,2010,52,52,8,8,8,0,0,2
"SW Tait ",2007,2011,35,35,8,8,8,0,0,2
"Tapash Baisya ",2002,2007,56,56,8,8,8,0,0,1
"SR Taylor ",2019,2020,12,12,8,8,8,0,0,2
"SR Thompson ",2013,2017,20,19,8,8,8,0,0,1
"N Vanua ",2014,2019,23,23,8,8,8,0,0,2
"MRJ Veletta ",1987,1989,20,20,8,8,7,1,0,3
"DM Wellham ",1981,1987,17,17,8,8,8,0,0,2
"LR Williams ",1996,2001,15,15,8,8,8,0,0,2
"KJ Wright ",1979,1979,5,5,8,8,0,8,0,2
"KJ Abbott ",2013,2016,28,27,7,7,7,0,0,2
"Abdur Rehman ",2006,2014,31,31,7,7,7,0,0,2
"PR Adams ",1996,2003,24,24,7,7,7,0,0,2
"Al Sahariar ",1999,2003,29,29,7,7,7,0,0,2
"Asif Iqbal ",1973,1979,10,10,7,7,7,0,0,2
"KBJ Azad ",1980,1986,25,24,7,7,7,0,0,2
"GEF Barnett ",2006,2010,22,22,7,7,7,0,0,1
"DE Bernard ",2003,2010,20,19,7,7,7,0,0,1
"IS Billcliff ",2003,2009,19,19,7,7,7,0,0,2
"D Bishoo ",2011,2019,42,41,7,7,7,0,0,1
"GS Blewett ",1995,1999,32,32,7,7,7,0,0,2
"JL Carter ",2015,2019,33,32,7,7,7,0,0,2
"NM Coulter-Nile ",2013,2019,32,32,7,7,7,0,0,1
"CD de Lange ",2016,2017,13,13,7,7,7,0,0,3
"TBM de Leede ",1996,2007,29,29,7,7,7,0,0,2
"JL Denly ",2009,2020,16,16,7,7,7,0,0,2
"AIC Dodemaide ",1988,1993,24,24,7,7,7,0,0,2
"MG Erasmus ",2019,2020,8,8,7,7,7,0,0,2
"CJ Ferguson ",2009,2011,30,29,7,7,7,0,0,2
"SR Gillespie ",1986,1988,19,19,7,7,7,0,0,2
"G Goudie ",2008,2013,16,16,7,7,7,0,0,2
"AW Greig ",1972,1977,22,21,7,7,7,0,0,3
"R Gunasekera ",2008,2014,19,19,7,7,7,0,0,2
"GM Hamilton ",1999,2010,38,38,7,6,6,0,1,1
"AS Hansra ",2010,2014,24,24,7,7,7,0,0,1
"MN Hart ",1994,2002,13,13,7,7,7,0,0,2
"DL Hemp ",2006,2009,22,22,7,7,7,0,0,3
"AG Huckle ",1997,1999,19,19,7,7,7,0,0,2
"Humayun Farhat ",2001,2001,5,5,7,4,0,4,3,3
"KAD Hurdle ",2006,2007,19,19,7,7,7,0,0,1
"Imam-ul-Haq ",2017,2019,37,36,7,7,7,0,0,1
"Jahurul Islam ",2010,2013,14,14,7,7,3,4,0,3
"NG Jones ",2010,2011,14,14,7,7,7,0,0,2
"S Randiv ",2009,2016,31,30,7,7,7,0,0,1
"SHT Kandamby ",2004,2014,39,38,7,7,7,0,0,2
"P Khadka ",2018,2020,10,10,7,7,7,0,0,3
"Khawar Ali ",2019,2020,11,11,7,7,7,0,0,2
"Kuldeep Yadav ",2017,2020,60,59,7,7,7,0,0,1
"NR Kumar ",2010,2014,16,16,7,7,7,0,0,2
"RN Lewis ",1997,2009,28,28,7,7,7,0,0,1
"NM Lyon ",2012,2019,29,29,7,7,7,0,0,2
"PD McGlashan ",2009,2009,4,4,7,7,0,7,0,3
"CJ McKay ",2009,2014,59,59,7,7,7,0,0,3
"CS Martin ",2001,2008,20,19,7,7,7,0,0,1
"SW Masakadza ",2010,2014,16,16,7,7,7,0,0,3
"Mehrab Hossain jnr ",2006,2009,18,18,7,7,7,0,0,1
"Mohammad Mithun ",2014,2020,27,27,7,7,7,0,0,2
"VV Morea ",2014,2018,13,13,7,7,7,0,0,2
"CT Mutombodzi ",2013,2020,14,14,7,7,7,0,0,3
"B Muzarabani ",2018,2018,18,18,7,7,7,0,0,2
"Naimur Rahman ",1995,2002,29,29,7,7,7,0,0,2
"J Nyumbu ",2014,2015,19,19,7,7,7,0,0,2
"NN Odhiambo ",2006,2014,69,69,7,7,7,0,0,1
"PP Ojha ",2008,2012,18,18,7,7,7,0,0,3
"E Otieno ",2007,2014,26,26,7,7,7,0,0,2
"MK Pandey ",2015,2020,26,26,7,7,7,0,0,1
"BJ Patel ",2001,2006,31,31,7,7,7,0,0,1
"H Patel ",2009,2013,23,22,7,7,7,0,0,2
"SR Patel ",2008,2013,36,36,7,7,7,0,0,2
"NS Poonia ",2006,2009,21,20,7,7,7,0,0,2
"S Prasanna ",2011,2019,40,40,7,7,7,0,0,1
"C Pringle ",1990,1995,64,64,7,7,7,0,0,1
"SMA Priyanjan ",2013,2015,23,23,7,7,7,0,0,1
"DJ Reekers ",2006,2009,19,19,7,7,7,0,0,2
"KW Richardson ",2013,2020,25,25,7,7,7,0,0,2
"BG Rogers ",2002,2005,15,15,7,7,7,0,0,1
"V Shankar ",2019,2019,12,12,7,7,7,0,0,1
"C Sharma ",1983,1994,65,64,7,7,7,0,0,1
"SK Sharma ",1988,1990,23,23,7,7,7,0,0,2
"M Sheikh ",1997,2000,21,21,7,7,7,0,0,1
"L Sivaramakrishnan ",1985,1987,16,16,7,7,7,0,0,3
"GC Small ",1987,1992,53,53,7,7,7,0,0,2
"RP Snell ",1991,1996,42,42,7,7,7,0,0,1
"Sohag Gazi ",2012,2014,20,20,7,7,7,0,0,2
"TB Sole ",2018,2019,10,10,7,7,7,0,0,2
"S Sreesanth ",2005,2011,53,52,7,7,7,0,0,1
"WF Stelling ",2006,2007,15,15,7,7,7,0,0,1
"ES Szwarczynski ",2006,2014,41,41,7,7,7,0,0,1
"Taskin Ahmed ",2014,2017,32,31,7,7,7,0,0,1
"CJ Tavare ",1980,1984,29,29,7,7,7,0,0,2
"JWA Taylor ",2011,2015,27,27,7,7,7,0,0,3
"AC Voges ",2007,2013,31,31,7,7,7,0,0,2
"DF Watts ",2006,2011,36,35,7,7,7,0,0,2
"VJ Wells ",1999,1999,9,9,7,7,7,0,0,3
"Aftab Alam ",2010,2019,27,27,6,6,6,0,0,2
"AC Agar ",2015,2020,13,13,6,6,6,0,0,1
"FA Allen ",2018,2020,14,13,6,6,6,0,0,2
"Ashfaq Ahmed ",2018,2019,16,16,6,6,6,0,0,2
"IDR Bradshaw ",2004,2007,62,62,6,6,6,0,0,1
"JP Bray ",2006,2007,15,15,6,6,5,1,0,2
"AD Brown ",1996,2001,16,16,6,6,6,0,0,2
"DG Brownlie ",2012,2017,16,16,6,6,6,0,0,1
"Mudassar Bukhari ",2007,2014,46,46,6,6,6,0,0,1
"LJ Burger ",2003,2003,6,6,6,6,6,0,0,3
"DJ Callaghan ",1992,2000,29,28,6,6,6,0,0,2
"DJ Capel ",1987,1990,23,23,6,6,6,0,0,2
"TL Chatara ",2013,2019,70,70,6,6,6,0,0,1
"S Chattergoon ",2006,2009,18,17,6,6,6,0,0,2
"TS Chisoro ",2015,2018,18,17,6,6,6,0,0,2
"GR Codrington ",2006,2007,17,17,6,6,6,0,0,1
"DG Cork ",1992,2002,32,32,6,6,6,0,0,2
"CD Cumming ",2003,2009,13,13,6,6,6,0,0,2
"WM Darling ",1978,1982,18,17,6,6,6,0,0,3
"TN de Grooth ",2006,2013,34,34,6,6,6,0,0,1
"AM de Silva ",1986,1993,4,4,6,4,0,4,2,3
"EAR de Silva ",1986,1992,28,28,6,6,6,0,0,2
"T Duffin ",2006,2007,23,23,6,6,6,0,0,1
"PH Edmonds ",1977,1987,29,29,6,6,6,0,0,2
"Enamul Haque ",1990,2002,29,29,6,6,6,0,0,3
"N Pradeep ",2012,2020,45,44,6,6,6,0,0,2
"WIA Fernando ",2016,2020,18,18,6,6,6,0,0,2
"G Fowler ",1983,1986,26,26,6,4,2,2,2,3
"AD Gaekwad ",1975,1987,15,14,6,6,6,0,0,1
"MR Gillespie ",2006,2009,32,31,6,6,6,0,0,2
"Hamza Tariq ",2011,2014,7,7,6,5,0,5,1,2
"RJ Harris ",2009,2012,21,21,6,6,6,0,0,1
"Harvinder Singh ",1997,2001,16,16,6,6,6,0,0,1
"Hasibul Hossain ",1995,2004,32,32,6,6,6,0,0,2
"UC Hathurusingha ",1992,1999,35,35,6,6,6,0,0,1
"VA Holder ",1973,1978,12,12,6,6,6,0,0,1
"BC Hollioake ",1997,2002,20,20,6,6,6,0,0,1
"MG Hughes ",1988,1993,33,33,6,6,6,0,0,1
"Ikram Alikhil ",2019,2019,12,11,6,3,0,3,3,2
"Imtiaz Abbasi ",1994,1996,7,7,6,4,0,4,2,2
"RC Irani ",1996,2003,31,31,6,6,6,0,0,1
"WR James ",1992,1996,11,11,6,6,3,3,0,2
"TP Kamungozi ",2006,2015,14,14,6,6,6,0,0,2
"AY Karim ",1996,2003,34,34,6,6,6,0,0,1
"Karim Sadiq ",2009,2016,24,24,6,6,6,0,0,2
"Khurram Khan ",2004,2015,16,16,6,6,6,0,0,2
"CL King ",1976,1980,18,18,6,6,6,0,0,1
"JK Lever ",1976,1982,22,22,6,6,6,0,0,2
"DK Liyanage ",1992,2001,16,16,6,6,6,0,0,2
"NB Mahwire ",2004,2006,23,23,6,6,6,0,0,2
"Manjural Islam Rana ",2003,2006,25,25,6,6,6,0,0,1
"JJ Martin ",1999,2001,10,10,6,6,6,0,0,3
"Mehrab Hossain ",1998,2003,18,18,6,6,6,0,0,2
"Mohammad Naveed ",2014,2019,39,39,6,6,6,0,0,1
"JFM Morrison ",1975,1983,18,18,6,6,6,0,0,2
"Mujeeb Ur Rahman ",2017,2019,40,39,6,6,6,0,0,1
"Mushfiqur Rahman ",2000,2004,28,28,6,6,6,0,0,1
"MV Nagamootoo ",2000,2002,24,24,6,6,6,0,0,1
"A Nao ",2017,2019,13,13,6,6,6,0,0,2
"Nazmul Hossain ",2004,2012,38,38,6,6,6,0,0,1
"SN Netravalkar ",2019,2020,13,13,6,6,6,0,0,3
"JO Ngoche ",2010,2013,17,17,6,6,6,0,0,1
"ML Nkala ",1998,2006,50,50,6,6,6,0,0,1
"AH Omarshah ",1983,1996,28,28,6,6,6,0,0,2
"SD Outerbridge ",2006,2009,23,23,6,6,6,0,0,1
"LS Pascoe ",1977,1982,29,29,6,6,6,0,0,1
"TRO Payne ",1984,1987,7,7,6,6,4,2,0,2
"VD Philander ",2007,2015,30,28,6,6,6,0,0,2
"N Pokana ",2017,2019,14,14,6,6,6,0,0,3
"D Pretorius ",2016,2019,22,22,6,6,6,0,0,2
"AJ Pycroft ",1983,1992,20,20,6,6,6,0,0,2
"CG Rackemann ",1983,1991,52,52,6,6,6,0,0,1
"Rameez Shahzad ",2016,2018,15,15,6,6,6,0,0,1
"BA Reid ",1986,1992,61,61,6,6,6,0,0,2
"AME Roberts ",1975,1983,56,56,6,6,6,0,0,1
"RT Robinson ",1984,1988,26,26,6,6,6,0,0,2
"FA Rose ",1997,2000,27,27,6,6,6,0,0,1
"Sandeep Goud ",2019,2020,11,11,6,6,6,0,0,2
"Shabir Noori ",2010,2016,10,10,6,6,6,0,0,2
"Sharjeel Khan ",2013,2017,25,25,6,6,6,0,0,1
"AK Sharma ",1988,1993,31,31,6,6,6,0,0,2
"MM Sharma ",2013,2015,26,25,6,6,6,0,0,1
"RJ Sidebottom ",2001,2010,25,25,6,6,6,0,0,1
"EO Simons ",1994,1995,23,23,6,6,6,0,0,1
"TAM Siriwardana ",2015,2019,27,26,6,6,6,0,0,2
"ZE Surkari ",2008,2011,23,22,6,6,6,0,0,1
"RML Taylor ",2013,2016,15,15,6,6,6,0,0,2
"Tushar Imran ",2001,2007,41,41,6,6,6,0,0,1
"Umar Amin ",2010,2018,16,16,6,6,6,0,0,2
"DL Underwood ",1973,1982,26,26,6,6,6,0,0,2
"AV Vadher ",1997,1999,18,18,6,6,6,0,0,2
"LP van Troost ",2002,2007,23,23,6,6,6,0,0,1
"Y Venugopal Rao ",2005,2006,16,16,6,6,6,0,0,2
"R Vinay Kumar ",2010,2013,31,31,6,6,6,0,0,2
"MHN Walker ",1974,1981,17,17,6,6,6,0,0,1
"MRJ Watt ",2016,2019,27,27,6,6,6,0,0,1
"AGD Wickremasinghe ",1992,1993,4,4,6,2,0,2,4,3
"B Wood ",1972,1982,13,13,6,6,6,0,0,2
"Yasir Shah ",2011,2019,25,25,6,6,6,0,0,2
"Zeeshan Maqsood ",2019,2020,11,11,6,6,6,0,0,2
"Abdul Shakoor ",2015,2018,3,3,5,4,2,2,1,3
"GI Allott ",1997,2000,31,31,5,5,5,0,0,1
"Anshuman Rath ",2014,2018,18,18,5,5,5,0,0,1
"Arafat Sunny ",2014,2015,16,16,5,5,5,0,0,1
"V Aravind ",2019,2020,6,6,5,4,0,4,1,3
"Arshad Ayub ",1987,1990,32,32,5,5,5,0,0,1
"Asif Ali ",2018,2019,18,17,5,5,5,0,0,1
"JT Ball ",2016,2018,18,18,5,5,5,0,0,3
"CA Best ",1986,1992,24,23,5,5,5,0,0,2
"U Bhatti ",2006,2010,36,35,5,5,5,0,0,1
"SL Boock ",1978,1987,14,13,5,5,5,0,0,1
"G Boycott ",1971,1981,36,35,5,5,5,0,0,3
"DH Brain ",1992,1995,23,23,5,5,5,0,0,2
"RD Brown ",1983,1987,7,7,5,5,5,0,0,2
"RJ Campbell ",2002,2002,2,2,5,4,0,4,1,3
"IM Chappell ",1971,1980,16,16,5,5,5,0,0,2
"PKD Chase ",2015,2018,25,24,5,5,5,0,0,2
"NG Cowans ",1983,1985,23,23,5,5,5,0,0,1
"CE Cuffy ",1994,2002,41,41,5,5,5,0,0,1
"WW Daniel ",1978,1984,18,18,5,5,5,0,0,1
"SP Davis ",1986,1988,39,39,5,5,5,0,0,1
"MH Dekker ",1992,1996,23,23,5,5,5,0,0,1
"JW Dernbach ",2011,2013,24,24,5,5,5,0,0,2
"DS de Silva ",1975,1985,41,41,5,5,5,0,0,1
"PWH de Silva ",2017,2020,15,15,5,5,5,0,0,2
"K Doriga ",2017,2019,14,14,5,4,1,3,1,1
"VC Drakes ",1995,2004,34,34,5,5,5,0,0,1
"GD Drummond ",2007,2013,30,29,5,5,5,0,0,1
"H Durham ",2006,2006,9,9,5,5,5,0,0,2
"GN Edwards ",1976,1981,6,6,5,5,3,2,0,2
"RMS Eranga ",2011,2016,19,18,5,5,5,0,0,2
"SM Ervine ",2001,2004,42,42,5,5,5,0,0,1
"Faheem Ashraf ",2017,2019,23,22,5,5,5,0,0,1
"SE Findlay ",2008,2009,9,9,5,5,5,0,0,2
"ARC Fraser ",1989,1999,42,42,5,5,5,0,0,1
"RS Gavaskar ",2004,2004,11,11,5,5,5,0,0,2
"AFG Griffith ",1996,2000,9,9,5,5,5,0,0,2
"Hamid Hassan ",2009,2019,38,37,5,5,5,0,0,1
"BR Hartland ",1992,1994,16,16,5,5,5,0,0,1
"JW Hastings ",2010,2017,29,29,5,5,5,0,0,2
"RC Haynes ",1989,1991,8,8,5,5,5,0,0,2
"EE Hemmings ",1982,1991,33,33,5,5,5,0,0,1
"M Hendrick ",1973,1981,22,22,5,5,5,0,0,1
"RS Higgins ",2006,2006,11,11,5,5,5,0,0,1
"PJC Hoffmann ",2006,2007,18,17,5,5,5,0,0,1
"MJ Hoggard ",2001,2006,26,26,5,5,5,0,0,1
"PJ Hughes ",2013,2014,25,25,5,5,3,2,0,2
"RO Hurley ",2003,2004,9,9,5,5,5,0,0,2
"Imran Haider ",2017,2019,20,20,5,5,5,0,0,1
"Jatinder Singh ",2019,2020,11,11,5,5,5,0,0,1
"WS Jayantha ",2004,2004,17,17,5,5,5,0,0,1
"HAPW Jayawardene ",2003,2007,6,6,5,4,0,4,1,2
"TE Jesty ",1983,1983,10,10,5,5,5,0,0,2
"VB John ",1982,1987,45,45,5,5,5,0,0,1
"MO Jones ",2006,2007,12,12,5,5,5,0,0,3
"RJ Kirtley ",2001,2004,11,11,5,5,5,0,0,1
"Krishna Chandran ",2014,2016,12,12,5,5,5,0,0,2
"BP Kruger ",2010,2011,5,5,5,5,5,0,0,3
"BM Laird ",1979,1982,23,23,5,5,5,0,0,1
"D Langford-Smith ",2006,2008,22,21,5,5,5,0,0,2
"KS Lokuarachchi ",2003,2007,21,21,5,5,5,0,0,1
"GI Maiden ",2010,2011,7,7,5,5,0,5,0,3
"JS Malhotra ",2019,2019,5,5,5,4,0,4,1,2
"GA Manou ",2009,2009,4,4,5,5,0,5,0,3
"A Mishra ",2003,2016,36,35,5,5,5,0,0,1
"Mohammad Asif ",2005,2010,38,36,5,5,5,0,0,2
"Mohammad Hussain ",1997,1998,14,13,5,5,5,0,0,2
"Mohammad Nawaz ",2016,2019,15,15,5,5,5,0,0,2
"Mohammad Tauqir ",2004,2015,11,11,5,5,5,0,0,2
"MD Moxon ",1985,1988,8,8,5,5,5,0,0,2
"AN Petersen ",2006,2013,21,21,5,5,5,0,0,1
"N Pothas ",2000,2000,3,3,5,4,0,4,1,3
"Qaiser Ali ",2006,2008,17,17,5,5,5,0,0,2
"JF Reid ",1980,1986,25,23,5,5,5,0,0,1
"DM Richards ",2009,2010,8,8,5,5,5,0,0,2
"Sadiq Mohammad ",1973,1980,19,19,5,5,5,0,0,2
"MAR Samarasekera ",1983,1994,39,39,5,5,5,0,0,2
"BS Sandhu ",1982,1984,22,21,5,5,5,0,0,1
"Shahadat Hossain ",2006,2013,51,51,5,5,5,0,0,1
"Shahriar Hossain ",1997,2004,20,20,5,5,5,0,0,1
"T Shamsi ",2016,2020,22,21,5,5,5,0,0,2
"Shapoor Zadran ",2009,2019,44,44,5,5,5,0,0,1
"Sharafuddin Ashraf ",2014,2019,17,17,5,5,5,0,0,3
"JJ Smit ",2019,2020,8,8,5,5,5,0,0,2
"JN Snape ",2001,2002,10,10,5,5,5,0,0,2
"CA Soper ",2016,2019,20,20,5,5,5,0,0,2
"ELR Stewart ",1993,2002,6,6,5,5,0,5,0,2
"MR Swart ",2011,2014,12,12,5,5,5,0,0,2
"J Theron ",2010,2020,13,13,5,5,5,0,0,2
"I Udana ",2012,2020,18,18,5,5,5,0,0,2
"Wajahatullah Wasti ",1999,2000,15,15,5,5,5,0,0,1
"BGK Walker ",2000,2002,11,11,5,5,5,0,0,1
"B Warnapura ",1975,1982,12,12,5,5,5,0,0,2
"SR Waters ",2008,2011,20,20,5,5,5,0,0,2
"CG Williams ",2019,2020,8,8,5,5,5,0,0,2
"GH Worker ",2015,2018,10,10,5,5,5,0,0,3
"GN Yallop ",1978,1984,30,27,5,5,5,0,0,2
"Ziaur Rahman ",2013,2014,13,13,5,5,5,0,0,1
"Adnan Mufti ",2017,2018,18,18,4,4,4,0,0,1
"Ahsan Malik ",2011,2014,12,12,4,4,4,0,0,2
"DS Airee ",2018,2020,10,10,4,4,4,0,0,1
"Amir Hayat ",2018,2019,9,9,4,4,4,0,0,1
"Anwar Ali ",2013,2016,22,22,4,4,4,0,0,2
"Aqib Ilyas ",2019,2020,11,11,4,4,4,0,0,2
"JC Archer ",2019,2019,14,14,4,4,4,0,0,1
"J Arun Lal ",1982,1989,13,13,4,4,4,0,0,1
"Atiq-uz-Zaman ",2000,2000,3,3,4,3,0,3,1,3
"AM Bacher ",1997,2005,13,13,4,4,4,0,0,2
"SB Bangar ",2002,2004,15,15,4,4,4,0,0,2
"GD Barlow ",1976,1977,6,6,4,4,4,0,0,2
"GJ Batty ",2002,2009,10,10,4,4,4,0,0,2
"T Bavuma ",2016,2020,6,5,4,4,4,0,0,2
"AC Bedade ",1994,1994,13,12,4,4,4,0,0,1
"BS Bedi ",1974,1979,10,10,4,4,4,0,0,3
"KCG Benjamin ",1992,1996,26,26,4,4,4,0,0,2
"TL Best ",2004,2014,26,26,4,4,4,0,0,1
"BR Blair ",1982,1986,14,13,4,4,4,0,0,2
"DR Brown ",1997,2007,25,25,4,4,4,0,0,1
"HR Bryan ",1999,1999,15,15,4,4,4,0,0,1
"IP Butchart ",1983,1995,20,20,4,4,4,0,0,1
"GD Campbell ",1989,1990,12,12,4,4,4,0,0,1
"KED Carroll ",2007,2007,6,6,4,4,4,0,0,2
"PVD Chameera ",2015,2019,23,23,4,4,4,0,0,1
"BB Chari ",2015,2019,11,10,4,3,2,1,1,2
"DN Chudasama ",1996,1999,20,20,4,4,4,0,0,1
"ST Clarke ",1978,1982,10,10,4,4,4,0,0,1
"GJ Cosier ",1975,1979,9,8,4,4,4,0,0,2
"TK Curran ",2017,2020,20,20,4,4,4,0,0,1
"PC de Silva ",2014,2017,7,7,4,4,4,0,0,2
"GR Dilley ",1979,1988,36,36,4,4,4,0,0,2
"FH Edwards ",2003,2009,50,49,4,4,4,0,0,1
"SA Edwards ",2018,2019,4,4,4,4,0,4,0,3
"D Elgar ",2012,2018,8,8,4,4,4,0,0,2
"FM Engineer ",1974,1975,5,5,4,3,0,3,1,1
"KWR Fletcher ",1971,1982,24,23,4,4,4,0,0,1
"DR Flynn ",2008,2012,20,20,4,4,4,0,0,1
"PJ Forrest ",2012,2012,15,15,4,4,4,0,0,1
"RC Fredericks ",1973,1977,12,12,4,4,4,0,0,1
"HJW Gardiner ",2013,2015,11,11,4,4,4,0,0,2
"HM Goonatilleke ",1982,1982,6,6,4,0,0,0,4,2
"TR Gripper ",2001,2003,8,8,4,4,4,0,0,2
"Hammad Azam ",2011,2015,11,11,4,4,4,0,0,2
"Haseeb Amjad ",2014,2016,7,7,4,4,4,0,0,1
"BF Hastings ",1973,1975,11,11,4,4,4,0,0,2
"M Hayward ",1998,2002,21,21,4,4,4,0,0,1
"MC Henriques ",2009,2017,11,11,4,4,4,0,0,2
"PA Hitchcock ",2002,2008,14,13,4,4,4,0,0,1
"RD Jackman ",1974,1983,15,15,4,4,4,0,0,1
"SC Joseph ",2000,2005,13,13,4,4,4,0,0,1
"BD Julien ",1973,1977,12,12,4,4,4,0,0,1
"S Jyoti ",2006,2010,14,13,4,4,4,0,0,1
"Kaleemullah ",2019,2020,9,9,4,4,4,0,0,2
"RB Kanhai ",1973,1975,7,7,4,4,4,0,0,1
"MF Kent ",1981,1981,5,5,4,4,4,0,0,2
"RD King ",1998,2005,50,50,4,4,4,0,0,1
"RK Kleinveldt ",2013,2013,10,10,4,4,4,0,0,2
"A Kuruvilla ",1997,1997,25,25,4,4,4,0,0,1
"RP Lefebvre ",1996,2003,11,11,4,4,4,0,0,1
"RT Lyons ",2006,2010,25,25,4,4,4,0,0,1
"WK McCallan ",2006,2009,39,37,4,4,4,0,0,1
"MJ McClenaghan ",2013,2016,48,46,4,4,4,0,0,1
"A McGrath ",2003,2004,14,13,4,4,4,0,0,2
"MW Machan ",2013,2016,23,22,4,4,4,0,0,1
"AO Malhotra ",1982,1986,20,20,4,4,4,0,0,1
"AA Mallett ",1971,1975,9,9,4,4,4,0,0,1
"WP Masakadza ",2015,2018,17,17,4,4,4,0,0,2
"AD Mascarenhas ",2007,2009,20,20,4,4,4,0,0,2
"MJ Mason ",2003,2010,26,25,4,4,4,0,0,1
"MP Maynard ",1994,2000,14,13,4,4,4,0,0,1
"G Miller ",1977,1984,25,25,4,4,4,0,0,2
"Mohsin Kamal ",1984,1989,19,19,4,4,4,0,0,1
"Mominul Haque ",2012,2018,28,28,4,4,4,0,0,1
"PWA Mulder ",2017,2019,10,10,4,4,4,0,0,2
"Nasir Jamal ",2014,2018,16,15,4,4,4,0,0,2
"EO Odumbe ",1996,1996,8,8,4,4,4,0,0,1
"GAHM Parkar ",1982,1984,10,8,4,4,4,0,0,2
"MD Patel ",2019,2020,13,13,4,4,3,1,0,1
"SS Pathirana ",2015,2017,18,18,4,4,4,0,0,2
"ASA Perera ",1998,2001,20,20,4,4,4,0,0,2
"NO Perry ",1999,2000,21,21,4,4,4,0,0,3
"MJ Petrie ",2009,2009,4,4,4,3,0,3,1,2
"AM Phangiso ",2013,2016,21,21,4,4,4,0,0,1
"IL Philip ",1999,1999,3,3,4,4,4,0,0,3
"Qasim Umar ",1983,1987,31,30,4,4,4,0,0,1
"V Rathour ",1996,1997,7,7,4,4,4,0,0,2
"PWE Rawson ",1983,1987,10,10,4,4,4,0,0,2
"Raza-ur-Rehman ",2013,2014,6,6,4,4,4,0,0,4
"V Razdan ",1989,1990,3,3,4,4,4,0,0,2
"JA Richardson ",2018,2020,13,13,4,4,4,0,0,1
"MJG Rippon ",2013,2018,6,6,4,4,4,0,0,1
"RD Robinson ",1977,1977,2,2,4,3,0,3,1,4
"RL Sanghvi ",1998,1998,10,10,4,4,4,0,0,2
"Shahid Nazir ",1996,2000,17,17,4,4,4,0,0,1
"A Shahzad ",2010,2011,11,11,4,4,4,0,0,2
"Sikander Bakht ",1977,1989,27,27,4,4,4,0,0,1
"RB Simpson ",1978,1978,2,2,4,4,4,0,0,2
"GM Strydom ",2006,2006,12,12,4,4,4,0,0,2
"Tareq Aziz ",2002,2004,10,10,4,4,4,0,0,1
"R Telemachus ",1998,2006,37,37,4,4,4,0,0,1
"S Thuraisingam ",2003,2008,10,10,4,4,4,0,0,2
"T Thushara ",2008,2010,38,38,4,4,4,0,0,1
"DT Tiripano ",2014,2020,34,33,4,4,4,0,0,1
"MK Tiwary ",2008,2015,12,11,4,4,4,0,0,3
"G Toka ",2019,2019,7,7,4,4,4,0,0,2
"CT Tremlett ",2005,2011,15,15,4,4,4,0,0,1
"RJ Trott ",2007,2009,11,11,4,4,4,0,0,1
"PCR Tufnell ",1990,1997,20,20,4,4,4,0,0,2
"Usman Limbada ",2010,2014,11,11,4,4,4,0,0,2
"RH Vance ",1988,1989,8,8,4,4,4,0,0,2
"RE van der Merwe ",2009,2019,15,15,4,4,4,0,0,1
"M van Jaarsveld ",2002,2004,11,11,4,4,4,0,0,1
"M van Schoor ",2003,2003,5,5,4,4,0,4,0,2
"JTC Vaughan ",1992,1996,18,18,4,4,4,0,0,1
"S Venkataraghavan ",1974,1983,15,15,4,4,4,0,0,1
"R Vijay Bharadwaj ",1999,2002,10,10,4,4,4,0,0,1
"JM Vince ",2015,2019,13,13,4,4,4,0,0,2
"BV Vitori ",2011,2018,24,24,4,4,4,0,0,1
"RM West ",2008,2009,10,9,4,4,4,0,0,1
"P Willey ",1977,1986,26,26,4,4,4,0,0,1
"BA Williams ",2002,2004,25,24,4,4,4,0,0,2
"JW Wilson ",1993,2005,6,6,4,4,4,0,0,2
"Aarif Sheikh ",2018,2020,10,10,3,3,3,0,0,2
"Abid Ali ",2019,2019,4,4,3,3,3,0,0,2
"MR Adair ",2019,2020,12,12,3,3,3,0,0,1
"CJ Adams ",1998,2000,5,5,3,3,3,0,0,1
"Adeel Raja ",2002,2011,21,21,3,3,3,0,0,1
"Adnan Akmal ",2011,2012,5,5,3,3,0,3,0,1
"RG Aga ",2004,2014,12,12,3,3,3,0,0,1
"Aizaz Khan ",2014,2018,19,19,3,3,3,0,0,1
"MW Alleyne ",1999,2000,10,10,3,3,3,0,0,1
"TR Ambrose ",2008,2008,5,5,3,3,0,3,0,1
"J Anderson ",2014,2016,8,8,3,3,3,0,0,2
"KJ Arnott ",1987,1993,13,13,3,3,3,0,0,1
"Azeem Hafeez ",1983,1985,15,15,3,3,3,0,0,2
"SV Bahutule ",1997,2003,8,8,3,3,3,0,0,2
"WD Balaji Rao ",2008,2011,10,10,3,3,3,0,0,1
"ST Banerjee ",1991,1992,6,6,3,3,3,0,0,1
"AB Barath ",2010,2012,14,13,3,3,3,0,0,1
"OO Bascome ",2008,2008,6,6,3,3,3,0,0,1
"JP Behrendorff ",2019,2019,11,11,3,3,3,0,0,1
"DM Benkenstein ",1998,2002,23,23,3,3,3,0,0,1
"HK Bennett ",2010,2020,19,19,3,3,3,0,0,1
"STR Binny ",2014,2015,14,12,3,3,3,0,0,2
"RJ Blakey ",1992,1993,3,3,3,2,0,2,1,2
"SM Boland ",2016,2016,14,14,3,3,3,0,0,1
"LE Bosman ",2006,2010,14,14,3,3,3,0,0,2
"DAJ Bracewell ",2011,2019,19,19,3,3,3,0,0,1
"KC Brathwaite ",2016,2017,10,10,3,3,3,0,0,1
"CPS Chauhan ",1978,1981,7,7,3,3,3,0,0,1
"Chirag Suri ",2018,2020,17,17,3,3,3,0,0,1
"NE Clarke ",1996,1996,5,5,3,3,3,0,0,1
"D Dasgupta ",2001,2001,5,5,3,2,0,2,1,1
"AG Davies ",1999,1999,5,5,3,2,0,2,1,2
"AP Devcich ",2013,2016,12,12,3,3,3,0,0,1
"LHD Dilhara ",2005,2013,9,9,3,3,3,0,0,1
"DR Doshi ",1980,1982,15,15,3,3,3,0,0,1
"Ehsan Khan ",2016,2018,15,15,3,3,3,0,0,2
"CE Eksteen ",1991,1994,6,6,3,3,3,0,0,1
"AM Ellis ",2012,2013,15,15,3,3,3,0,0,2
"PA Emery ",1994,1994,1,1,3,3,0,3,0,3
"JJ Esmeijer ",2002,2003,6,6,3,3,3,0,0,2
"GM Ewing ",2004,2005,7,7,3,3,3,0,0,2
"Faisal Hossain ",2004,2010,6,6,3,3,3,0,0,1
"Faisal Iqbal ",2000,2006,18,18,3,3,3,0,0,1
"TCB Fernando ",2001,2003,17,17,3,3,3,0,0,2
"BT Foakes ",2019,2019,1,1,3,2,0,2,1,3
"CR Foggo ",2008,2008,4,4,3,3,3,0,0,2
"JN Frylinck ",2019,2020,8,8,3,3,3,0,0,2
"OD Gibson ",1995,1997,15,15,3,3,3,0,0,1
"DR Gilbert ",1986,1986,14,14,3,3,3,0,0,1
"AH Gray ",1985,1991,25,25,3,3,3,0,0,1
"EJ Gray ",1984,1988,10,10,3,3,3,0,0,2
"PW Gunaratne ",2002,2003,23,23,3,3,3,0,0,1
"Haroon Rasheed ",1977,1982,12,12,3,3,3,0,0,1
"Hazratullah Zazai ",2018,2019,16,15,3,3,3,0,0,1
"DW Headley ",1996,1999,13,13,3,3,3,0,0,1
"SP Heaney ",2006,2006,4,4,3,3,3,0,0,2
"IG Holland ",2019,2020,8,8,3,3,3,0,0,2
"HJ Howarth ",1973,1975,9,9,3,3,3,0,0,1
"Iftikhar Ahmed ",2015,2019,4,4,3,3,3,0,0,1
"PJ Ingram ",2010,2010,8,8,3,3,3,0,0,1
"Iqbal Qasim ",1977,1988,15,15,3,3,3,0,0,1
"SD Jack ",1994,1995,2,2,3,3,3,0,0,2
"PA Jaques ",2006,2007,6,6,3,3,3,0,0,1
"Joginder Sharma ",2004,2007,4,4,3,3,3,0,0,1
"MA Jones ",2018,2019,8,8,3,3,3,0,0,1
"Junaid Siddiqui ",2011,2014,9,9,3,3,3,0,0,1
"SKW Kelly ",2006,2009,10,10,3,3,3,0,0,1
"D Keulder ",2003,2003,6,6,3,3,3,0,0,2
"AR Khurasiya ",1999,2001,12,12,3,3,3,0,0,1
"Khurram Chohan ",2009,2014,25,24,3,3,3,0,0,1
"Khurram Manzoor ",2008,2009,7,7,3,3,3,0,0,1
"BA King ",2019,2020,4,4,3,3,3,0,0,1
"LJ Koen ",1997,2000,5,5,3,3,3,0,0,2
"DB Kotze ",2003,2003,6,6,3,3,3,0,0,1
"AP Kuiper ",1991,1996,25,25,3,3,3,0,0,1
"CBRLS Kumara ",2017,2019,13,13,3,3,3,0,0,1
"T Kumaran ",1999,2000,8,8,3,3,3,0,0,1
"JL Langer ",1994,1997,8,8,3,2,1,1,1,1
"D Lloyd ",1973,1980,8,8,3,3,3,0,0,1
"BP Loots ",2010,2011,7,7,3,3,3,0,0,2
"CA Lynn ",2017,2018,4,4,3,3,3,0,0,2
"RB McCosker ",1975,1982,14,14,3,3,3,0,0,1
"AJ McKay ",2010,2012,19,19,3,3,3,0,0,1
"N Madziva ",2014,2016,12,12,3,3,3,0,0,1
"MAWR Madurasinghe ",1988,1992,12,12,3,3,3,0,0,1
"Majid Khan ",1973,1982,23,23,3,3,3,0,0,1
"JN Malan ",2020,2020,3,3,3,3,3,0,0,3
"G Malla ",2018,2020,10,10,3,3,3,0,0,1
"A Martin ",2011,2011,9,9,3,3,3,0,0,1
"TBA May ",1987,1995,47,47,3,3,3,0,0,2
"M Mbangwa ",1996,2002,29,29,3,3,3,0,0,1
"Mohammad Nadeem ",2019,2020,10,10,3,3,3,0,0,1
"Mohammad Saifuddin ",2017,2020,22,22,3,3,3,0,0,1
"JN Mohammed ",2011,2018,28,27,3,3,3,0,0,1
"R Murray ",2018,2018,5,5,3,3,0,3,0,1
"Mushtaq Mohammad ",1973,1978,10,10,3,3,3,0,0,1
"JD Nel ",2006,2010,19,19,3,3,3,0,0,1
"RAP Nissanka ",2001,2003,23,23,3,3,3,0,0,1
"Nurul Hasan ",2016,2016,2,2,3,2,0,2,1,3
"LN Onyango ",1996,2014,29,29,3,3,3,0,0,1
"ARM Opatha ",1975,1979,5,5,3,3,3,0,0,2
"MS Panesar ",2007,2007,26,26,3,3,3,0,0,1
"MA Parker ",2010,2010,10,10,3,3,3,0,0,1
"JL Pattinson ",2011,2015,15,15,3,3,3,0,0,1
"RK Paudel ",2018,2020,5,5,3,3,3,0,0,1
"RR Powar ",2004,2007,31,30,3,3,3,0,0,1
"MR Pydanna ",1980,1983,3,3,3,2,0,2,1,1
"S Ramesh ",1999,1999,24,23,3,3,3,0,0,1
"SHA Rance ",2017,2017,2,2,3,3,3,0,0,3
"Rashid Khan ",1980,1985,29,28,3,3,3,0,0,1
"AJ Redmond ",2009,2010,6,6,3,3,3,0,0,1
"RB Reid ",1988,1991,9,9,3,3,3,0,0,1
"FL Reifer ",1997,2009,8,8,3,3,3,0,0,1
"GR Robertson ",1994,1998,13,13,3,3,3,0,0,1
"DB Rundle ",1994,1994,2,2,3,3,3,0,0,2
"NA Saini ",2019,2020,5,5,3,3,3,0,0,2
"Saleem Jaffar ",1986,1990,39,39,3,3,3,0,0,1
"DP Samaraweera ",1993,1994,5,5,3,3,3,0,0,2
"MMC Schewe ",1996,1996,5,5,3,2,0,2,1,3
"E Schiferli ",2002,2013,30,30,3,3,3,0,0,1
"Shamsur Rahman ",2013,2014,10,10,3,3,3,0,0,2
"MD Shanaka ",2016,2019,22,22,3,3,3,0,0,1
"KV Sharma ",2014,2014,2,2,3,3,3,0,0,2
"VRV Singh ",2006,2006,2,2,3,3,3,0,0,2
"TT Smart ",2004,2004,2,2,3,3,1,2,0,2
"CJ Smith ",2006,2007,12,12,3,3,3,0,0,2
"S Snater ",2018,2018,2,2,3,3,3,0,0,2
"Sohail Khan ",2008,2016,13,13,3,3,3,0,0,1
"CB Sole ",2016,2018,11,11,3,3,3,0,0,2
"MC Sorensen ",2013,2016,13,12,3,3,3,0,0,1
"DA Stirling ",1984,1984,6,6,3,3,3,0,0,1
"PC Strydom ",2000,2000,10,10,3,3,3,0,0,2
"R Strydom ",2008,2008,9,8,3,3,3,0,0,1
"Tanveer Ahmed ",2016,2018,6,6,3,3,3,0,0,2
"Tanwir Afzal ",2014,2018,20,20,3,3,3,0,0,1
"APB Tennekoon ",1975,1979,4,4,3,3,3,0,0,1
"SN Thakur ",2017,2020,11,11,3,3,3,0,0,1
"AJ Traicos ",1983,1993,27,27,3,3,3,0,0,1
"A Turner ",1975,1975,6,6,3,3,3,0,0,2
"Usman Ghani ",2014,2017,15,15,3,3,3,0,0,1
"Usman Shinwari ",2017,2019,17,17,3,3,3,0,0,2
"JJ van der Wath ",2006,2007,10,10,3,3,3,0,0,1
"K Verreynne ",2020,2020,3,3,3,3,3,0,0,3
"GR Viswanath ",1974,1982,25,25,3,3,3,0,0,1
"Waheed Ahmed ",2019,2020,5,5,3,3,3,0,0,1
"Waqas Barkat ",2014,2018,10,10,3,3,3,0,0,1
"SM Warnapura ",2007,2008,3,3,3,3,3,0,0,2
"PN Webb ",1983,1984,5,5,3,3,0,3,0,1
"K Weeraratne ",2000,2008,15,15,3,3,3,0,0,1
"DS Wesonga ",2010,2011,4,4,3,3,3,0,0,2
"S Wettimuny ",1982,1987,35,35,3,3,3,0,0,1
"BTJ Wheal ",2016,2019,13,13,3,3,3,0,0,1
"SG Whittingham ",2017,2019,5,5,3,3,3,0,0,1
"KIW Wijegunawardene ",1988,1992,26,26,3,3,3,0,0,1
"RA Woolmer ",1972,1976,6,6,3,3,3,0,0,1
"Jai P Yadav ",2002,2005,12,12,3,3,3,0,0,2
"Zahoor Khan ",2017,2019,17,17,3,3,3,0,0,1
"M Zondeki ",2002,2008,13,13,3,3,3,0,0,1
"Aamir Kaleem ",2019,2019,2,2,2,2,2,0,0,1
"Aaron Jones ",2019,2020,13,13,2,2,2,0,0,1
"Abdur Rauf ",2008,2008,4,4,2,2,2,0,0,1
"Aizaz Cheema ",2011,2012,14,14,2,2,2,0,0,1
"PJW Allott ",1982,1985,13,13,2,2,2,0,0,1
"SW Ambris ",2017,2020,13,13,2,2,2,0,0,1
"DL Amiss ",1972,1977,18,17,2,2,2,0,0,1
"JO Angara ",1997,2003,17,17,2,2,2,0,0,1
"SA Ankola ",1989,1997,20,20,2,2,2,0,0,1
"GG Arnold ",1972,1975,14,13,2,2,2,0,0,1
"TD Astle ",2017,2019,9,9,2,2,2,0,0,1
"Athar Ali Khan ",1988,1998,19,19,2,2,2,0,0,1
"Azam Khan ",1996,1998,6,6,2,2,2,0,0,1
"Azhar Hossain ",1988,1990,7,7,2,2,2,0,0,1
"Azhar Saeed ",1994,1996,7,7,2,2,2,0,0,1
"SJ Baard ",2019,2020,8,8,2,2,2,0,0,1
"Badal Singh ",2020,2020,2,2,2,2,2,0,0,2
"S Badrinath ",2008,2011,7,7,2,2,2,0,0,2
"IPP Batuwitarachchi ",2008,2008,2,2,2,2,2,0,0,2
"AR Berenger ",2014,2015,10,10,2,2,2,0,0,1
"RA Bhatti ",2011,2011,1,1,2,2,0,2,0,2
"RL Bhudia ",2008,2009,5,5,2,2,2,0,0,1
"MP Bicknell ",1990,1991,7,7,2,2,2,0,0,1
"Bilal Asif ",2015,2015,3,3,2,2,2,0,0,2
"Bilawal Bhatti ",2013,2015,10,10,2,2,2,0,0,1
"DCC Borden ",2006,2008,12,12,2,2,2,0,0,1
"GE Bradburn ",1990,2001,11,11,2,2,2,0,0,1
"RJ Bright ",1974,1986,11,11,2,2,2,0,0,1
"VR Brown ",1988,1988,3,3,2,2,2,0,0,1
"PA Browne ",2008,2008,5,5,2,2,0,2,0,1
"MG Burmester ",1992,1995,8,8,2,2,2,0,0,1
"JA Burns ",2015,2015,6,6,2,2,2,0,0,1
"IW Callen ",1978,1982,5,5,2,2,2,0,0,1
"J Cameron-Dow ",2019,2019,4,4,2,2,2,0,0,1
"MA Carberry ",2013,2014,6,5,2,2,2,0,0,1
"JJ Celestine ",2007,2008,8,8,2,2,2,0,0,1
"DR Chumney ",2003,2007,21,21,2,2,2,0,0,1
"PG Coman ",1973,1974,3,3,2,2,2,0,0,1
"G Cook ",1981,1983,6,6,2,2,2,0,0,1
"NGB Cook ",1984,1989,3,3,2,2,2,0,0,1
"BN Cooper ",2013,2019,8,8,2,2,2,0,0,1
"JP Crawley ",1994,1999,13,13,2,1,1,0,1,1
"DJ Cullen ",2006,2006,5,5,2,2,2,0,0,1
"D Daesrath ",2012,2013,4,4,2,2,2,0,0,2
"Danish Kaneria ",2001,2007,18,18,2,2,2,0,0,1
"HT Davis ",1994,1997,11,11,2,2,2,0,0,1
"AC Dawson ",1998,2004,19,19,2,2,2,0,0,1
"RP de Groen ",1993,1994,12,12,2,2,2,0,0,1
"PA Desai ",2010,2014,13,13,2,2,2,0,0,1
"GRA de Silva ",1975,1982,6,6,2,2,2,0,0,1
"MW Douglas ",1994,1995,6,6,2,2,2,0,0,1
"TM Dowlin ",2009,2010,11,11,2,2,2,0,0,1
"KG Duers ",1992,1992,6,6,2,2,2,0,0,1
"SF Dukanwala ",1996,1996,5,5,2,2,2,0,0,1
"CI Dunusinghe ",1995,1995,1,1,2,1,0,1,1,2
"NR Dyer ",1999,1999,5,5,2,2,2,0,0,1
"KA Edwards ",2011,2014,16,16,2,2,2,0,0,1
"Ehsan Nawaz ",2014,2018,12,12,2,2,2,0,0,1
"RM Ellison ",1984,1986,14,14,2,2,2,0,0,2
"EA Essop-Adam ",1992,1992,1,1,2,2,2,0,0,2
"Fahim Muntasir ",2001,2002,3,3,2,2,2,0,0,1
"Fareed Ahmad ",2014,2017,5,4,2,2,2,0,0,1
"Faruk Ahmed ",1988,1999,7,7,2,2,2,0,0,1
"Fayyaz Butt ",2019,2019,5,5,2,2,2,0,0,1
"KHRK Fernando ",2002,2006,7,7,2,2,2,0,0,1
"AN French ",2004,2004,2,2,2,2,2,0,0,1
"D Gamage ",2003,2003,3,3,2,2,2,0,0,1
"JC Gamage ",1995,1995,4,4,2,2,2,0,0,1
"PLS Gamage ",2014,2017,9,9,2,2,2,0,0,1
"KD Ghavri ",1975,1981,19,19,2,2,2,0,0,1
"GJ Gilmour ",1974,1975,5,5,2,2,2,0,0,1
"DM Gondaria ",2013,2013,2,2,2,2,2,0,0,1
"TG Gordon ",2011,2011,5,5,2,2,2,0,0,1
"K Gore ",2019,2020,10,10,2,2,2,0,0,1
"Z Groenewald ",2019,2019,4,4,2,2,2,0,0,1
"TGJ Gruijters ",2010,2013,5,5,2,2,2,0,0,1
"DR Hadlee ",1973,1976,11,11,2,2,2,0,0,1
"Hafizur Rahman ",1986,1986,2,2,2,2,0,2,0,1
"PL Harris ",2008,2008,3,3,2,2,2,0,0,1
"C Hemraj ",2018,2018,6,6,2,2,2,0,0,2
"BE Hendricks ",2019,2020,7,5,2,2,2,0,0,1
"RO Hinds ",2001,2004,14,14,2,2,2,0,0,1
"ND Hirwani ",1988,1992,18,18,2,2,2,0,0,1
"LG Howell ",1998,1998,12,12,2,2,2,0,0,1
"GW Humpage ",1981,1981,3,3,2,2,0,2,0,1
"EH Hutchinson ",2019,2020,6,6,2,2,2,0,0,1
"N Ifill ",2003,2006,4,4,2,2,2,0,0,1
"Ijaz Faqih ",1980,1988,27,27,2,2,2,0,0,1
"IT Iqbal ",1996,1996,3,3,2,2,0,2,0,2
"AJ Ireland ",2005,2007,26,26,2,2,2,0,0,1
"Irfan Ahmed ",2008,2014,6,6,2,2,2,0,0,2
"KA Jamieson ",2020,2020,2,2,2,2,2,0,0,2
"LR Johnson ",2008,2015,6,6,2,2,2,0,0,1
"SMS Kaluperuma ",1988,1988,2,2,2,2,2,0,0,1
"FJ Klaassen ",2018,2019,4,4,2,2,2,0,0,2
"JJ Krejza ",2011,2011,8,8,2,2,2,0,0,1
"P Krishnamurthy ",1976,1976,1,1,2,1,0,1,1,2
"N Kruger ",2011,2011,2,2,2,2,2,0,0,2
"DS Kulkarni ",2014,2016,12,12,2,2,2,0,0,1
"NM Kulkarni ",1997,1998,10,10,2,2,2,0,0,1
"RR Kulkarni ",1983,1987,10,10,2,2,2,0,0,1
"S Lamichhane ",2018,2020,10,10,2,2,2,0,0,1
"B Laughlin ",2009,2009,5,5,2,2,2,0,0,1
"P Lever ",1971,1975,10,9,2,2,2,0,0,1
"GD Lloyd ",1996,1998,6,6,2,2,2,0,0,1
"SCG MacGill ",2000,2000,3,3,2,2,2,0,0,1
"BJ McKechnie ",1975,1981,14,14,2,2,2,0,0,1
"KH MacLeay ",1983,1987,16,16,2,2,2,0,0,1
"TN Madondo ",1998,2001,13,13,2,2,2,0,0,1
"JN Maguire ",1983,1984,23,21,2,2,2,0,0,1
"I Maraj ",2003,2003,6,6,2,2,2,0,0,1
"A Maregwede ",2003,2005,11,11,2,2,2,0,0,1
"EH Mattis ",1981,1981,2,2,2,2,2,0,0,1
"B Mavuta ",2018,2019,7,7,2,2,2,0,0,1
"TMK Mawoyo ",2006,2014,7,7,2,2,2,0,0,1
"MC Mendis ",1995,1995,1,1,2,2,2,0,0,2
"Minhajul Abedin ",1986,1999,27,27,2,2,2,0,0,1
"Mohammad Kashif ",2006,2010,11,11,2,2,2,0,0,1
"Mohammad Khalil ",2005,2005,3,3,2,2,2,0,0,1
"Mohammad Naim ",2020,2020,1,1,2,2,2,0,0,2
"Mohammad Shahzad ",2014,2016,6,6,2,2,2,0,0,1
"Mohammed Qasim ",2017,2017,5,5,2,2,2,0,0,1
"Mohibullah Oryakhel ",2013,2013,2,2,2,2,2,0,0,1
"GMC Mol ",2007,2008,6,6,2,2,2,0,0,2
"HJC Mol ",2002,2008,11,11,2,2,2,0,0,1
"PJK Mooney ",2006,2007,4,4,2,2,2,0,0,2
"JE Morris ",1990,1991,8,8,2,2,2,0,0,1
"Morshed Ali Khan ",1998,1998,3,3,2,2,2,0,0,1
"JK Moss ",1979,1979,1,1,2,2,2,0,0,2
"EMDY Munaweera ",2017,2017,2,2,2,2,2,0,0,1
"W Mwayenga ",2002,2004,3,3,2,2,2,0,0,1
"SJ Myburgh ",2011,2018,13,13,2,2,2,0,0,1
"Nafees Iqbal ",2003,2005,16,16,2,2,2,0,0,1
"PG Nana ",1975,1975,3,3,2,2,2,0,0,1
"Nasir Ahmed ",1988,1990,7,7,2,1,0,1,1,1
"Naved Latif ",2001,2003,11,11,2,2,2,0,0,1
"Naveen-ul-Haq ",2016,2019,4,4,2,2,2,0,0,1
"Najmul Hossain Shanto ",2018,2020,5,5,2,2,2,0,0,2
"Nazmul Islam ",2018,2018,5,5,2,2,2,0,0,1
"TS Nethula ",2012,2012,5,5,2,2,2,0,0,1
"A Nortje ",2019,2020,7,7,2,2,2,0,0,2
"MP O'Dowd ",2019,2019,2,2,2,2,2,0,0,1
"FN Otieno ",2010,2010,4,4,2,2,2,0,0,1
"C Overton ",2018,2018,1,1,2,2,2,0,0,2
"JV Paranjpe ",1998,1998,4,4,2,2,2,0,0,1
"TK Patel ",2019,2020,7,7,2,2,2,0,0,1
"D Paterson ",2017,2019,4,4,2,2,2,0,0,2
"GA Paterson ",1983,1987,10,10,2,2,2,0,0,1
"MDK Perera ",2007,2018,13,12,2,2,2,0,0,1
"PDRL Perera ",1999,2007,19,19,2,2,2,0,0,1
"Pervez Mir ",1975,1977,3,3,2,2,2,0,0,1
"RG Petrie ",1990,1991,12,12,2,2,2,0,0,1
"OL Pitcher ",2007,2007,5,5,2,2,2,0,0,1
"MW Priest ",1990,1998,18,18,2,2,2,0,0,1
"MW Pringle ",1992,1994,17,17,2,2,2,0,0,1
"PM Pushpakumara ",2017,2017,2,2,2,2,2,0,0,1
"NV Radford ",1988,1988,6,6,2,2,2,0,0,2
"Raees Ahmadzai ",2009,2010,5,5,2,2,2,0,0,1
"LS Rajput ",1985,1987,4,4,2,2,2,0,0,1
"WV Raman ",1988,1996,27,27,2,2,2,0,0,1
"S Ranatunga ",1994,1996,13,13,2,2,2,0,0,1
"D Ravu ",2017,2019,8,8,2,2,2,0,0,1
"B Reddy ",1978,1981,3,3,2,2,0,2,0,1
"IR Redpath ",1971,1975,5,5,2,2,2,0,0,1
"CP Rizwan ",2019,2020,9,9,2,2,2,0,0,1
"Rizwan-uz-Zaman ",1981,1987,3,3,2,2,2,0,0,2
"GK Robertson ",1981,1989,10,10,2,2,2,0,0,1
"GA Rogers ",2006,2008,13,12,2,2,2,0,0,1
"GRJ Roope ",1973,1978,8,7,2,2,2,0,0,1
"LG Rowe ",1975,1980,11,11,2,2,2,0,0,1
"Rumman Raees ",2017,2018,9,9,2,2,2,0,0,1
"HD Rutherford ",2013,2013,4,4,2,2,2,0,0,1
"Saeed Azad ",1995,1996,4,4,2,2,2,0,0,1
"AK Sah ",2018,2018,2,2,2,2,0,2,0,2
"AM Salvi ",2003,2003,4,4,2,2,2,0,0,1
"Sameer Zia ",2004,2004,1,1,2,2,2,0,0,2
"Saqib Ali ",2008,2014,5,5,2,2,2,0,0,1
"Saqlain Haider ",2014,2016,5,5,2,1,0,1,1,1
"Sarandeep Singh ",2002,2003,5,5,2,2,2,0,0,1
"AF Sattaur ",2003,2003,3,3,2,2,2,0,0,2
"BM Scholtz ",2019,2020,8,8,2,2,2,0,0,2
"S Seeraj ",2006,2006,1,1,2,2,0,2,0,2
"KF Semple ",1999,1999,7,7,2,2,2,0,0,1
"CP Senanayake ",1990,1991,7,7,2,2,2,0,0,1
"Shaheen Shah Afridi ",2018,2019,19,18,2,2,2,0,0,1
"Shahid Saeed ",1989,1993,10,10,2,2,2,0,0,1
"Shahid Wasif ",2016,2018,10,10,2,2,2,0,0,1
"G Sharma ",1985,1987,11,11,2,2,2,0,0,1
"TG Shaw ",1991,1994,9,9,2,2,2,0,0,1
"MQ Sheikh ",2008,2010,7,7,2,2,2,0,0,1
"R Shepherd ",2019,2020,5,5,2,2,2,0,0,1
"IT Shillingford ",1978,1978,2,2,2,2,2,0,0,1
"DJM Short ",2018,2020,8,8,2,2,2,0,0,1
"JT Smuts ",2020,2020,5,4,2,2,2,0,0,2
"ED Solkar ",1974,1976,7,7,2,2,2,0,0,1
"IM Stanger ",1999,2006,5,5,2,2,2,0,0,1
"CAH Stevenson ",2019,2020,7,7,2,2,2,0,0,1
"GB Stevenson ",1980,1981,4,4,2,2,2,0,0,1
"AM Stuart ",1997,1997,3,3,2,2,2,0,0,2
"Taslim Arif ",1980,1980,2,2,2,1,1,0,1,1
"SP Terry ",2016,2016,5,5,2,2,2,0,0,2
"LO Tikolo ",1996,1996,3,3,2,2,2,0,0,1
"SS Tiwary ",2010,2010,3,3,2,2,2,0,0,1
"RJW Topley ",2015,2016,10,10,2,2,2,0,0,1
"GB Troup ",1976,1985,22,22,2,2,2,0,0,1
"TE Tucker ",2008,2009,5,5,2,2,2,0,0,1
"AJ Turner ",2019,2020,6,6,2,2,2,0,0,1
"KEA Upashantha ",1995,2001,12,12,2,2,2,0,0,1
"PS Vaidya ",1995,1996,4,4,2,2,2,0,0,1
"JDF Vandersay ",2015,2019,12,12,2,2,2,0,0,1
"RF van Oosterom ",1996,2002,3,3,2,2,2,0,0,1
"C Viljoen ",2019,2019,2,2,2,2,2,0,0,2
"KDK Vithanage ",2013,2014,6,6,2,2,2,0,0,1
"MDJ Walker ",2003,2003,3,3,2,2,2,0,0,1
"HR Walsh ",2019,2020,10,10,2,2,2,0,0,1
"KPJ Warnaweera ",1990,1993,6,6,2,2,2,0,0,1
"AS Wassan ",1990,1991,9,9,2,2,2,0,0,1
"DS Weerakkody ",2017,2017,3,3,2,2,2,0,0,1
"UWMBCA Welegedara ",2009,2010,10,9,2,2,2,0,0,1
"JM Wiener ",1979,1980,7,7,2,2,2,0,0,1
"RGCE Wijesuriya ",1982,1985,8,8,2,2,2,0,0,1
"HS Williams ",1999,2000,7,7,2,2,2,0,0,2
"PJ Wiseman ",1998,2003,15,14,2,2,2,0,0,1
"RD Woolley ",1983,1983,4,2,2,1,0,1,1,2
"Yamin Ahmadzai ",2015,2019,4,4,2,2,2,0,0,1
"Yasir Arafat ",2000,2009,11,11,2,2,2,0,0,1
"B Yograj Singh ",1980,1981,6,6,2,2,2,0,0,1
"BE Young ",1998,1999,6,6,2,2,2,0,0,1
"CA Young ",2014,2020,14,13,2,2,2,0,0,1
"Zahid Fazal ",1990,1994,19,19,2,2,2,0,0,1
"Zahoor Elahi ",1996,1997,14,14,2,2,2,0,0,1
"Zulqarnain Haider ",2010,2010,4,4,2,1,0,1,1,2
"NP Kenjige ",2019,2020,5,5,1,1,1,0,0,1
"Aamer Hameed ",1977,1978,2,2,1,1,1,0,0,1
"VR Aaron ",2011,2014,9,9,1,1,1,0,0,1
"JS Ababu ",1999,2006,9,9,1,1,1,0,0,1
"Abdullah Mazari ",2010,2010,2,2,1,1,1,0,0,1
"Abdul Jabbar ",2007,2007,2,2,1,1,1,0,0,1
"S Abrahams ",2000,2000,1,1,1,1,1,0,0,1
"Abul Hasan ",2012,2018,7,7,1,1,1,0,0,1
"Abu Hider ",2018,2018,2,2,1,1,1,0,0,1
"Afzaal Haider ",2004,2008,4,4,1,1,1,0,0,1
"MA Agarwal ",2020,2020,3,3,1,1,1,0,0,1
"JP Agnew ",1985,1985,3,3,1,1,1,0,0,1
"KK Ahmed ",2018,2019,11,11,1,1,1,0,0,1
"Aijaz Ali ",2004,2004,2,2,1,1,1,0,0,1
"Kabir Ali ",2003,2006,14,13,1,1,1,0,0,1
"RW Ali ",1996,1997,9,9,1,1,1,0,0,1
"DI Allan ",2011,2013,5,5,1,1,1,0,0,1
"MJD Allingham ",1999,1999,3,3,1,1,1,0,0,1
"Al-Amin Hossain ",2014,2020,15,15,1,1,1,0,0,1
"S Amarnath ",1978,1978,3,3,1,1,1,0,0,1
"MKDI Amerasinghe ",2007,2008,8,8,1,1,1,0,0,1
"CR Amini ",2014,2014,2,2,1,1,1,0,0,1
"RW Anderson ",1976,1978,2,2,1,1,1,0,0,1
"Ankur Vasishta ",2014,2014,4,4,1,1,1,0,0,1
"Arshad Ali ",2004,2008,4,4,1,1,1,0,0,1
"Arshad Laeeq ",1994,1996,6,6,1,1,1,0,0,1
"Asif Masood ",1973,1976,7,7,1,1,1,0,0,1
"RJ Bailey ",1985,1990,4,4,1,1,1,0,0,1
"LS Baker ",2008,2009,10,9,1,1,1,0,0,1
"Basil Hameed ",2019,2020,6,6,1,1,1,0,0,1
"TC Bastiampillai ",2007,2014,13,13,1,1,1,0,0,1
"MD Bates ",2012,2012,2,2,1,1,1,0,0,1
"Bazid Khan ",2004,2008,5,5,1,1,1,0,0,1
"MD Bell ",1998,2001,7,7,1,1,1,0,0,1
"MJ Bennett ",1984,1985,8,8,1,1,1,0,0,1
"Bilal Khan ",2019,2020,10,10,1,1,1,0,0,1
"K Birkenstock ",2019,2020,8,8,1,1,1,0,0,1
"GA Bishop ",1987,1987,2,2,1,1,1,0,0,1
"J Blackwood ",2015,2015,2,2,1,1,1,0,0,1
"TA Blundell ",2020,2020,2,2,1,1,1,0,0,1
"GH Bodi ",2007,2007,2,2,1,1,1,0,0,1
"JWHD Boteju ",1999,1999,2,2,1,1,1,0,0,1
"JE Brinkley ",1999,1999,5,5,1,1,1,0,0,1
"RE Bryson ",1997,1997,7,7,1,1,1,0,0,1
"CE Bulfin ",1999,1999,4,4,1,1,1,0,0,1
"SF Burger ",2003,2003,2,2,1,1,1,0,0,1
"SJ Cameron ",2018,2018,2,2,1,1,1,0,0,1
"TK Canning ",2003,2005,4,4,1,1,1,0,0,1
"HWR Cartwright ",2017,2017,2,2,1,1,1,0,0,1
"MS Chapman ",2015,2020,6,6,1,1,1,0,0,1
"U Chatterjee ",1995,1995,3,3,1,1,1,0,0,1
"DB Close ",1972,1972,3,3,1,1,1,0,0,1
"RO Collinge ",1973,1978,15,15,1,1,1,0,0,1
"PC Connell ",2008,2010,13,12,1,1,1,0,0,1
"SJ Cook ",1991,1993,4,4,1,1,1,0,0,1
"GJ Crocker ",1992,1993,6,6,1,1,1,0,0,1
"CEH Croft ",1977,1981,19,19,1,1,1,0,0,1
"ML Cummins ",2014,2017,11,10,1,1,1,0,0,1
"KM Curran ",1983,1987,11,11,1,1,1,0,0,1
"BCJ Cutting ",2013,2014,4,4,1,1,1,0,0,1
"DDP D'Silva ",2019,2020,6,6,1,1,1,0,0,1
"CJ Dala ",2018,2018,2,2,1,1,1,0,0,1
"WW Davis ",1983,1988,35,35,1,1,1,0,0,1
"BFW de Leede ",2018,2019,3,3,1,1,1,0,0,1
"MH Denness ",1973,1975,12,12,1,1,1,0,0,1
"JH Desai ",2004,2004,1,1,1,1,1,0,0,1
"DLS de Silva ",1979,1979,2,2,1,1,1,0,0,1
"R Dhanraj ",1994,1995,6,6,1,1,1,0,0,1
"BJ Diamanti ",2009,2009,1,1,1,1,1,0,0,1
"AB Dinda ",2010,2013,13,13,1,1,1,0,0,1
"MJ Di Venuto ",1997,1997,9,9,1,1,1,0,0,1
"BL D'Oliveira ",1971,1972,4,4,1,1,1,0,0,1
"CJ Drum ",1999,1999,5,5,1,1,1,0,0,1
"G Dymock ",1974,1980,15,14,1,1,1,0,0,1
"RR Emrit ",2007,2007,2,2,1,1,1,0,0,1
"Fahad Usman ",2004,2004,2,2,1,1,1,0,0,1
"Fazle Mahmud ",2018,2018,2,2,1,1,1,0,0,1
"BOP Fernando ",2019,2019,6,6,1,1,1,0,0,1
"KADM Fernando ",2003,2003,1,1,1,1,1,0,0,1
"J Figy ",2019,2020,2,2,1,1,1,0,0,1
"MV Fleming ",1997,1998,11,11,1,1,1,0,0,1
"MJ Fourie ",2007,2008,7,6,1,1,1,0,0,1
"PJ Franks ",2000,2000,1,1,1,1,1,0,0,1
"RS Gabriel ",1984,1984,11,11,1,1,1,0,0,1
"ST Gabriel ",2016,2019,25,25,1,1,1,0,0,1
"WCA Ganegama ",2001,2006,4,4,1,1,1,0,0,1
"TN Garwe ",2009,2009,1,1,1,1,1,0,0,1
"SP Gauchan ",2018,2018,1,1,1,1,1,0,0,1
"Gazi Ashraf ",1986,1990,7,7,1,1,1,0,0,1
"B Geeves ",2008,2009,2,2,1,1,1,0,0,1
"SC Getkate ",2019,2019,3,3,1,1,1,0,0,1
"N Gifford ",1985,1985,2,2,1,1,1,0,0,1
"BD Glover ",2019,2019,1,1,1,1,1,0,0,1
"SF Graf ",1980,1981,11,11,1,1,1,0,0,1
"AP Grayson ",2000,2001,2,2,1,1,1,0,0,1
"Gurkeerat Singh ",2016,2016,3,3,1,1,1,0,0,1
"HF Gurney ",2014,2014,10,10,1,1,1,0,0,1
"Gursharan Singh ",1990,1990,1,1,1,1,1,0,0,1
"AM Guruge ",2014,2015,7,7,1,1,1,0,0,1
"RS Haire ",2008,2008,2,2,1,1,1,0,0,1
"JV Harris ",2003,2003,6,6,1,1,1,0,0,1
"RG Hart ",2002,2002,2,2,1,1,0,1,0,1
"Hasan Jamil ",1977,1978,6,6,1,1,1,0,0,1
"Hasan Raza ",1996,1999,16,15,1,1,1,0,0,1
"TJ Heggelman ",2010,2011,5,5,1,1,1,0,0,1
"O Henry ",1992,1992,3,3,1,1,1,0,0,1
"JG Heron ",1983,1983,6,6,1,1,1,0,0,1
"PD Heyn ",1975,1975,2,2,1,1,1,0,0,1
"AMJ Hilditch ",1979,1985,8,8,1,1,1,0,0,1
"KC Hodsoll ",2007,2008,3,3,1,1,1,0,0,1
"CK Hooper ",2007,2010,5,5,1,1,1,0,0,1
"KA Hope ",2017,2017,7,7,1,1,1,0,0,1
"AG Hurst ",1975,1979,8,7,1,1,1,0,0,1
"RO Hussain ",2006,2010,8,7,1,1,1,0,0,1
"KH Butt ",2008,2008,2,2,1,1,1,0,0,1
"DP Hyatt ",2011,2011,9,9,1,1,1,0,0,1
"Ibrahim Zadran ",2019,2019,1,1,1,1,1,0,0,1
"AP Igglesden ",1994,1994,4,4,1,1,1,0,0,1
"Ijaz Ahmed jnr ",1997,1997,2,2,1,1,1,0,0,1
"R Illingworth ",1971,1973,3,2,1,1,1,0,0,1
"Imran Abbas ",2000,2000,2,2,1,1,1,0,0,1
"MM Iqbal ",2009,2014,13,13,1,1,1,0,0,1
"Irfan Bhatti ",1993,1993,1,1,1,1,1,0,0,1
"Izatullah Dawlatzai ",2010,2015,5,5,1,1,1,0,0,1
"Jahangir Alam ",1997,1999,3,3,1,0,0,0,1,1
"Jahangir Shah ",1986,1990,5,5,1,1,1,0,0,1
"Jalal-ud-Din ",1982,1983,8,7,1,1,1,0,0,1
"Jamaluddin Ahmed ",2003,2003,1,1,1,1,1,0,0,1
"F Jansen ",1996,1996,2,2,1,1,1,0,0,1
"MP Jarvis ",1987,1995,12,12,1,1,1,0,0,1
"PW Jarvis ",1988,1993,16,16,1,1,1,0,0,1
"Javed Qadeer ",1995,1995,1,1,1,1,0,1,0,1
"SA Jayasinghe ",1979,1979,2,2,1,1,0,1,0,1
"GSNFG Jayasuriya ",2015,2019,12,12,1,1,1,0,0,1
"Jay Odedra ",2019,2020,3,3,1,1,1,0,0,1
"S Jeganathan ",1983,1988,5,5,1,1,1,0,0,1
"MR Johnson ",2004,2004,2,2,1,1,0,1,0,1
"MBS Jonkman ",2006,2010,16,16,1,1,1,0,0,1
"MMA Jonkman ",2007,2010,4,4,1,1,1,0,0,1
"DI Joyce ",2006,2007,3,3,1,1,1,0,0,1
"Jubair Hossain ",2014,2015,3,3,1,1,1,0,0,1
"Kabir Khan ",1994,2000,10,9,1,1,1,0,0,1
"Kamran Shazad ",2014,2015,4,4,1,1,1,0,0,1
"TS Kamunhukamwe ",2018,2020,6,6,1,1,1,0,0,1
"AR Kapoor ",1995,2000,17,17,1,1,1,0,0,1
"M Karg ",2003,2003,3,3,1,1,0,1,0,1
"SHU Karnain ",1984,1990,19,19,1,1,1,0,0,1
"S Kaul ",2018,2018,3,3,1,1,1,0,0,1
"RJ Kennedy ",1996,1996,7,7,1,1,1,0,0,1
"JC Kent ",2002,2002,2,2,1,1,1,0,0,1
"RB Kerr ",1985,1985,4,4,1,1,1,0,0,1
"S Keshvani ",2009,2009,5,4,1,1,1,0,0,1
"SP Khakurel ",2018,2020,5,5,1,0,0,0,1,1
"Khalid Latif ",2008,2010,5,5,1,1,1,0,0,1
"Khurram Nawaz ",2019,2019,3,3,1,1,1,0,0,1
"GE Kidd ",2007,2008,6,5,1,1,1,0,0,1
"J Kila ",2018,2019,6,6,1,1,1,0,0,1
"VJ Kingma ",2014,2019,3,3,1,1,1,0,0,1
"JF Kloppenburg ",2002,2003,6,6,1,1,1,0,0,1
"BL Kotze ",2003,2003,5,5,1,1,1,0,0,1
"GJP Kruger ",2006,2006,3,3,1,1,1,0,0,1
"CKB Kulasekara ",2011,2012,4,4,1,1,1,0,0,1
"M Labuschagne ",2020,2020,7,7,1,1,1,0,0,1
"JPR Lamsam ",2004,2008,2,2,1,1,1,0,0,1
"WM Lawry ",1971,1971,1,1,1,1,1,0,0,1
"ML Lewis ",2005,2006,7,7,1,1,1,0,0,1
"ACI Lock ",1996,1996,8,7,1,1,1,0,0,1
"JL Louw ",2003,2003,1,1,1,1,1,0,0,1
"JD Love ",1981,1981,3,3,1,1,1,0,0,1
"SW Lubbers ",1996,1996,4,4,1,1,1,0,0,1
"MJ Lumb ",2014,2014,3,3,1,1,1,0,0,1
"AS Luseno ",2003,2010,10,10,1,1,1,0,0,1
"MA Lynch ",1988,1988,3,3,1,1,1,0,0,1
"RJ McCurdy ",1985,1985,11,11,1,1,1,0,0,1
"PE McEwan ",1980,1985,17,17,1,1,1,0,0,1
"AJ Mackay ",2001,2001,3,3,1,1,1,0,0,1
"GD McKenzie ",1971,1971,1,1,1,1,1,0,0,1
"DL Maddy ",1998,2000,8,8,1,1,1,0,0,1
"W Madhevere ",2020,2020,3,3,1,1,1,0,0,1
"Mafizur Rahman ",1997,1997,4,4,1,1,1,0,0,1
"KA Maharaj ",2017,2020,7,7,1,1,1,0,0,1
"Mahbubul Alam ",2009,2009,5,5,1,1,1,0,0,1
"SI Mahmood ",2004,2009,26,26,1,1,1,0,0,1
"GT Main ",2019,2019,1,1,1,1,1,0,0,1
"DE Malcolm ",1990,1994,10,10,1,1,1,0,0,1
"MF Malone ",1977,1982,10,10,1,1,1,0,0,1
"Manzoor Akhtar ",1997,1998,7,7,1,1,1,0,0,1
"PJ Martin ",1995,1998,20,20,1,1,1,0,0,1
"RAL Massie ",1972,1972,3,3,1,1,1,0,0,1
"EZ Matambanadzo ",1996,1997,7,7,1,1,1,0,0,1
"Mazhar Hussain ",1994,1996,7,7,1,1,1,0,0,1
"JA McCollum ",2019,2020,9,9,1,1,1,0,0,1
"V Mehra ",1994,1996,6,6,1,1,1,0,0,1
"KP Meiyappan ",2019,2020,4,4,1,1,1,0,0,1
"KO Meth ",2006,2012,11,11,1,1,1,0,0,1
"JP Millmow ",1990,1990,5,5,1,1,1,0,0,1
"A Mithun ",2010,2011,5,5,1,1,1,0,0,1
"Mohammad Boota ",2018,2019,9,9,1,0,0,0,1,1
"Mohammad Hasnain ",2019,2019,5,5,1,1,1,0,0,1
"Mohammad Ishaq ",1994,1996,5,5,1,1,1,0,0,1
"Mohammad Salim ",2003,2003,1,1,1,1,0,1,0,1
"Mohammad Sharif ",2001,2007,9,9,1,1,1,0,0,1
"Mohammad Zahid ",1996,2002,11,11,1,1,1,0,0,1
"D Mohammed ",2006,2008,7,7,1,1,1,0,0,1
"Mosharraf Hossain ",2008,2016,5,5,1,1,1,0,0,1
"TV Mufambisi ",2006,2007,6,6,1,1,0,1,0,1
"SP Mukherjee ",1990,1991,3,3,1,1,1,0,0,1
"J Mulder ",2017,2017,4,4,1,1,1,0,0,1
"CT Mumba ",2016,2020,5,5,1,1,1,0,0,1
"N M'shangwe ",2011,2014,6,6,1,1,1,0,0,1
"DT Mutendera ",1999,2001,9,9,1,1,1,0,0,1
"G Mylvaganam ",1996,1996,3,3,1,1,1,0,0,1
"Naeemuddin Aslam ",2004,2004,2,2,1,1,1,0,0,1
"Naeem Ahmed ",1978,1978,1,1,1,1,1,0,0,1
"Najeeb Amar ",2004,2008,4,4,1,1,1,0,0,1
"Naseem Khushi ",2020,2020,6,6,1,1,1,0,0,1
"BP Nash ",2008,2009,9,8,1,1,1,0,0,1
"SV Nayak ",1981,1982,4,4,1,1,1,0,0,1
"Nazimuddin ",2008,2012,11,11,1,1,1,0,0,1
"Neeyamur Rashid ",1999,1999,2,2,1,1,1,0,0,1
"A Neill ",2019,2019,1,1,1,1,1,0,0,1
"R Ngarava ",2017,2018,9,9,1,1,1,0,0,1
"Noor-ul-Haq ",2010,2010,2,2,1,1,1,0,0,1
"MJ North ",2009,2009,2,2,1,1,1,0,0,1
"GH O'Brien ",2006,2008,9,9,1,1,1,0,0,1
"IE O'Brien ",2008,2009,10,10,1,1,1,0,0,1
"NM Odhiambo ",2010,2013,8,8,1,1,1,0,0,1
"NV Ojha ",2010,2010,1,1,1,0,0,0,1,1
"LN Oluoch ",2011,2011,2,2,1,1,1,0,0,1
"G Onions ",2009,2009,4,4,1,1,1,0,0,1
"Pankaj Singh ",2010,2010,1,1,1,1,1,0,0,1
"MHW Papps ",2004,2005,6,6,1,1,1,0,0,1
"JS Paris ",2016,2016,2,2,1,1,1,0,0,1
"NM Parker ",1976,1976,1,1,1,1,1,0,0,1
"AK Patel ",1984,1985,8,7,1,1,1,0,0,1
"BP Patel ",1974,1979,10,10,1,1,1,0,0,1
"NK Patel ",2019,2020,8,8,1,1,1,0,0,1
"J Patraj ",2007,2007,2,2,1,1,1,0,0,1
"SG Peall ",1992,1996,21,20,1,1,1,0,0,1
"AJ Penn ",1997,2001,5,5,1,1,1,0,0,1
"AK Perera ",2013,2019,6,6,1,1,1,0,0,1
"PARP Perera ",2019,2019,2,2,1,1,1,0,0,1
"V Permaul ",2012,2017,7,7,1,1,1,0,0,1
"AR Pitcher ",2006,2007,4,4,1,1,1,0,0,1
"V Pollard ",1973,1974,3,3,1,1,1,0,0,1
"RH Poonawala ",1994,1994,2,2,1,1,1,0,0,1
"GD Porter ",1979,1979,2,2,1,1,1,0,0,1
"KTGD Prasad ",2006,2015,24,24,1,1,1,0,0,1
"AG Puttick ",2005,2005,1,1,1,1,1,0,0,1
"Qadeer Ahmed ",2015,2019,11,11,1,1,1,0,0,1
"Rahat Ali ",2012,2016,14,14,1,1,1,0,0,1
"P Raho ",2014,2014,1,1,1,1,1,0,0,1
"LN Rajbanshi ",2019,2020,4,4,1,1,1,0,0,1
"CAK Rajitha ",2018,2019,9,9,1,1,1,0,0,1
"SK Ranasinghe ",1986,1986,4,4,1,1,1,0,0,1
"D Ranatunga ",1990,1990,4,4,1,1,1,0,0,1
"U Ranchod ",1992,1993,3,3,1,1,1,0,0,1
"Raqibul Hasan ",1986,1986,2,2,1,1,1,0,0,1
"JB Reva ",2016,2018,9,9,1,1,1,0,0,1
"ACL Richards ",2007,2007,1,1,1,1,1,0,0,1
"MH Richardson ",2002,2002,4,4,1,1,1,0,0,1
"Rizwan Ahmed ",2008,2008,1,1,1,1,1,0,0,1
"ADG Roberts ",1976,1976,1,1,1,1,1,0,0,1
"RJ Robinson ",2007,2009,3,3,1,1,1,0,0,1
"LN Roche ",2018,2018,3,3,1,1,1,0,0,1
"Rokhan Barakzai ",2015,2015,1,1,1,1,1,0,0,1
"LC Romero ",2004,2004,2,2,1,1,1,0,0,1
"BC Rose ",1977,1977,2,2,1,1,1,0,0,1
"MW Rushmere ",1992,1992,4,4,1,1,1,0,0,1
"Saadat Ali ",1984,1984,8,8,1,1,1,0,0,1
"Saeed-al-Saffar ",1996,1996,1,1,1,1,1,0,0,1
"Sajid Ali ",1984,1997,13,13,1,1,1,0,0,1
"Saleem Altaf ",1973,1978,6,6,1,1,1,0,0,1
"IDK Salisbury ",1993,1994,4,4,1,1,1,0,0,1
"G Salmond ",1999,1999,5,5,1,1,1,0,0,1
"JA Samarasekera ",1994,1996,7,7,1,1,1,0,0,1
"S Samarawickrama ",2017,2019,7,7,1,1,1,0,0,1
"Samiur Rahman ",1986,1986,2,2,1,1,1,0,0,1
"RG Samuels ",1996,1997,8,8,1,1,1,0,0,1
"KT Sandher ",2006,2007,15,15,1,1,1,0,0,1
"BB Seebaran ",2003,2003,4,4,1,1,1,0,0,1
"CS Serjeant ",1977,1978,3,3,1,1,1,0,0,1
"RK Sethi ",1975,1975,3,3,1,1,1,0,0,1
"Shadab Kabir ",1996,1996,3,3,1,1,1,0,0,1
"Shafiq Ahmed ",1977,1978,3,3,1,1,1,0,0,1
"KD Shah ",2014,2018,10,10,1,1,1,0,0,1
"Shahid Mahboob ",1982,1984,10,10,1,1,1,0,0,1
"Shan Masood ",2019,2019,5,5,1,1,1,0,0,1
"R Sharma ",2004,2004,2,2,1,1,1,0,0,1
"R Sharma ",2011,2012,4,4,1,1,1,0,0,1
"B Shikongo ",2020,2020,1,1,1,1,1,0,0,1
"LR Shukla ",1999,1999,3,3,1,1,1,0,0,1
"K Shuttleworth ",1971,1971,1,1,1,1,1,0,0,1
"PM Siddle ",2009,2019,20,19,1,1,1,0,0,1
"RW Sims ",2002,2003,3,3,1,1,1,0,0,1
"L Sipamla ",2020,2020,4,3,1,1,1,0,0,1
"MA Small ",1984,1984,2,2,1,1,1,0,0,1
"MJ Smith ",1973,1974,5,5,1,1,1,0,0,1
"NMK Smith ",1996,1996,7,7,1,1,1,0,0,1
"JA Snow ",1971,1975,9,8,1,1,1,0,0,1
"GS Sobers ",1973,1973,1,1,1,1,1,0,0,1
"Sohail Fazal ",1989,1989,2,2,1,1,1,0,0,1
"Sompal Kami ",2018,2019,6,6,1,1,1,0,0,1
"D Soraine ",2006,2012,4,4,1,1,1,0,0,1
"BB Sran ",2016,2016,6,6,1,1,1,0,0,1
"L Sreekumar ",2015,2016,4,4,1,1,1,0,0,1
"S Sriram ",2000,2004,8,8,1,1,1,0,0,1
"KR Stackpole ",1971,1974,6,6,1,1,1,0,0,1
"JH Stander ",2009,2012,5,5,1,1,1,0,0,1
"B Stanlake ",2017,2019,7,7,1,1,1,0,0,1
"LW Stokkers ",2008,2008,1,1,1,1,1,0,0,1
"LW Stott ",1979,1979,1,1,1,1,1,0,0,1
"CEL Stuart ",2001,2001,5,5,1,1,1,0,0,1
"ML Su'a ",1992,1995,12,12,1,1,1,0,0,1
"R Sudhakar Rao ",1976,1976,1,1,1,1,1,0,0,1
"Syed Maqsood ",2004,2004,2,2,1,1,1,0,0,1
"Taijul Islam ",2014,2020,9,9,1,1,1,0,0,1
"Talha Jubair ",2002,2003,6,6,1,1,1,0,0,1
"Tanbir Hayder ",2016,2016,2,2,1,1,1,0,0,1
"Tanvir Ahmed ",2011,2011,2,2,1,1,1,0,0,1
"BR Taylor ",1973,1973,2,2,1,1,1,0,0,1
"GJ Thompson ",2008,2008,3,3,1,1,1,0,0,1
"FJ Titmus ",1975,1975,2,2,1,1,1,0,0,1
"RW Tolchard ",1979,1979,1,1,1,1,0,1,0,1
"CP Tremain ",2016,2016,4,4,1,1,1,0,0,1
"JO Troughton ",2003,2003,6,5,1,1,1,0,0,1
"AJ Tudor ",2002,2002,3,3,1,1,1,0,0,1
"S Tyagi ",2009,2010,4,4,1,1,1,0,0,1
"AJ Tye ",2018,2018,7,7,1,1,1,0,0,1
"SD Udal ",1994,2005,11,11,1,1,1,0,0,1
"Umair Ali ",2015,2015,2,2,1,1,1,0,0,1
"Usman Salahuddin ",2011,2011,2,2,1,1,1,0,0,1
"JN Valentine ",1979,1979,3,3,1,1,1,0,0,1
"A van der Merwe ",2010,2011,9,9,1,1,1,0,0,1
"VB van Jaarsveld ",2009,2009,2,2,1,1,1,0,0,1
"S Vesawkar ",2018,2020,2,2,1,1,1,0,0,1
"TP Visee ",2019,2019,2,2,1,1,1,0,0,1
"AL Wadekar ",1974,1974,2,2,1,1,1,0,0,1
"I Wardlaw ",2013,2015,22,21,1,1,1,0,0,1
"Washington Sundar ",2017,2017,1,1,1,1,1,0,0,1
"SR Welsh ",2006,2008,3,3,1,1,1,0,0,1
"BA Westdijk ",2011,2011,4,4,1,1,1,0,0,1
"AG Wharf ",2004,2005,13,13,1,1,1,0,0,1
"BM Wheeler ",2015,2015,6,6,1,1,1,0,0,1
"JJ Whitaker ",1987,1987,2,2,1,1,1,0,0,1
"DJ White ",1990,1990,3,3,1,1,1,0,0,1
"P Wilson ",1997,1998,11,11,1,1,1,0,0,1
"WA Wisneski ",2000,2000,3,3,1,1,1,0,0,1
"DJ Worrall ",2016,2016,3,3,1,1,1,0,0,1
"CM Wright ",2006,2009,20,20,1,1,1,0,0,1
"M Yachad ",1991,1991,1,1,1,1,1,0,0,1
"J Yadav ",2016,2016,1,1,1,1,1,0,0,1
"NS Yadav ",1986,1987,7,7,1,1,1,0,0,1
"HN Ya France ",2019,2020,7,7,1,1,1,0,0,1
"B Yardley ",1978,1983,7,5,1,1,1,0,0,1
"Younis Ahmed ",1987,1987,2,2,1,1,1,0,0,1
"Zafar Iqbal ",1995,1995,8,8,1,1,1,0,0,1
"Zahid Hussain ",2011,2011,2,2,1,1,1,0,0,1
"Sultan Zarawani ",1994,1996,7,7,1,1,1,0,0,1
"AK Zesers ",1987,1987,2,2,1,1,1,0,0,1
"C Zhuwao ",2008,2018,9,9,1,1,1,0,0,1
"K Zondo ",2018,2018,5,5,1,1,1,0,0,1
"Zulfiqar Ali ",1975,1975,3,3,1,1,1,0,0,1
"ME Sanuth ",2020,2020,3,3,0,0,0,0,0,0
"Aamer Hanif ",1993,1995,5,5,0,0,0,0,0,0
"Aamer Nazir ",1993,1995,9,9,0,0,0,0,0,0
"Aamer Yamin ",2015,2018,4,4,0,0,0,0,0,0
"SA Abbott ",2014,2014,1,1,0,0,0,0,0,0
"Abdul Rehman ",2004,2004,1,1,0,0,0,0,0,0
"S Abid Ali ",1974,1975,5,5,0,0,0,0,0,0
"Abu Jayed ",2019,2019,2,2,0,0,0,0,0,0
"Afif Hossain ",2020,2020,1,1,0,0,0,0,0,0
"FS Ahangama ",1985,1985,1,1,0,0,0,0,0,0
"Ahmed Kamal ",1999,1999,1,1,0,0,0,0,0,0
"Ahmed Shah ",2009,2009,1,1,0,0,0,0,0,0
"KS Airee ",2020,2020,1,1,0,0,0,0,0,0
"Akhtar Sarfraz ",1997,1998,4,4,0,0,0,0,0,0
"Alawi Shukri ",2008,2008,1,1,0,0,0,0,0,0
"GW Aldridge ",2011,2011,2,2,0,0,0,0,0,0
"RP Alexander ",2004,2004,2,2,0,0,0,0,0,0
"Ali Asad ",2004,2004,2,2,0,0,0,0,0,0
"Ali Khan ",2019,2019,1,1,0,0,0,0,0,0
"KN Amalean ",1986,1988,8,8,0,0,0,0,0,0
"Aman Ali ",2008,2008,1,1,0,0,0,0,0,0
"Aminul Islam jnr ",1999,1999,1,1,0,0,0,0,0,0
"J Angel ",1994,1995,3,3,0,0,0,0,0,0
"Anisur Rahman ",1995,1998,2,2,0,0,0,0,0,0
"ZS Ansari ",2015,2015,1,1,0,0,0,0,0,0
"HAG Anthony ",1995,1995,3,3,0,0,0,0,0,0
"Anwar Hossain Monir ",2002,2002,1,1,0,0,0,0,0,0
"Anwar Hossain ",2002,2002,1,1,0,0,0,0,0,0
"GJAF Aponso ",1996,1996,5,5,0,0,0,0,0,0
"MA Aponso ",2016,2018,9,9,0,0,0,0,0,0
"Ariful Haque ",2018,2018,1,1,0,0,0,0,0,0
"Arshad Pervez ",1978,1978,2,2,0,0,0,0,0,0
"B Arun ",1986,1987,4,4,0,0,0,0,0,0
"Asad Ali ",2013,2013,4,4,0,0,0,0,0,0
"Asghar Ali ",2004,2004,2,2,0,0,0,0,0,0
"Ashfaq Ahmed ",1994,1994,3,3,0,0,0,0,0,0
"Asif Iqbal ",2015,2015,1,1,0,0,0,0,0,0
"Asif Mahmood ",1998,1998,2,2,0,0,0,0,0,0
"Asim Butt ",1999,1999,5,5,0,0,0,0,0,0
"Asim Saeed ",2004,2004,2,2,0,0,0,0,0,0
"SK Atai ",2019,2019,2,2,0,0,0,0,0,0
"Ata-ur-Rehman ",1992,1996,30,30,0,0,0,0,0,0
"ID Austin ",1998,1999,9,9,0,0,0,0,0,0
"RA Austin ",1978,1978,1,1,0,0,0,0,0,0
"Azmat Rana ",1978,1978,2,2,0,0,0,0,0,0
"MD Bailey ",1998,1998,1,1,0,0,0,0,0,0
"PJ Bakker ",1996,1996,5,5,0,0,0,0,0,0
"S Baksh ",1979,1979,1,1,0,0,0,0,0,0
"KMC Bandara ",2016,2016,1,1,0,0,0,0,0,0
"MRCN Bandaratilleke ",1998,1998,3,3,0,0,0,0,0,0
"OAC Banks ",2003,2005,5,5,0,0,0,0,0,0
"T Banton ",2020,2020,3,3,0,0,0,0,0,0
"KJ Barnett ",1988,1988,1,1,0,0,0,0,0,0
"DM Basden ",2007,2007,2,2,0,0,0,0,0,0
"GR Beard ",1981,1981,2,2,0,0,0,0,0,0
"RR Beaton ",2017,2017,2,2,0,0,0,0,0,0
"JE Benjamin ",1994,1995,2,2,0,0,0,0,0,0
"MR Benson ",1986,1986,1,1,0,0,0,0,0,0
"A Bhandari ",2000,2004,2,2,0,0,0,0,0,0
"LS Bhandari ",2018,2018,1,1,0,0,0,0,0,0
"M Bhanuka ",2019,2019,1,1,0,0,0,0,0,0
"S Bhari ",2020,2020,4,4,0,0,0,0,0,0
"Bhupinder Singh snr ",1994,1994,2,2,0,0,0,0,0,0
"MI Black ",2001,2001,5,5,0,0,0,0,0,0
"DL Blake ",2004,2004,1,1,0,0,0,0,0,0
"G Blakeney ",2009,2009,2,2,0,0,0,0,0,0
"A Bohara ",2020,2020,2,2,0,0,0,0,0,0
"SG Borthwick ",2011,2011,2,2,0,0,0,0,0,0
"T Bosch ",1992,1992,2,2,0,0,0,0,0,0
"GK Bose ",1974,1974,1,1,0,0,0,0,0,0
"KD Boyce ",1973,1975,8,8,0,0,0,0,0,0
"BP Bracewell ",1978,1978,1,1,0,0,0,0,0,0
"GA Briant ",1993,1993,5,5,0,0,0,0,0,0
"DR Briggs ",2012,2012,1,1,0,0,0,0,0,0
"SA Britton ",2009,2009,1,1,0,0,0,0,0,0
"D Brown ",2001,2002,3,3,0,0,0,0,0,0
"BS Browne ",1994,1994,4,4,0,0,0,0,0,0
"GK Bruk-Jackson ",1993,1993,1,1,0,0,0,0,0,0
"DE Budge ",2018,2019,3,3,0,0,0,0,0,0
"AJ Burger ",2003,2003,6,6,0,0,0,0,0,0
"AR Butcher ",1980,1980,1,1,0,0,0,0,0,0
"RO Butcher ",1980,1981,3,3,0,0,0,0,0,0
"DK Butler ",2005,2006,5,5,0,0,0,0,0,0
"RG Callender ",1979,1979,2,2,0,0,0,0,0,0
"JD Campbell ",2019,2019,6,5,0,0,0,0,0,0
"PE Cantrell ",1996,1996,5,5,0,0,0,0,0,0
"PH Carlson ",1979,1979,4,3,0,0,0,0,0,0
"NM Carter ",2013,2013,3,3,0,0,0,0,0,0
"DL Chahar ",2018,2019,3,3,0,0,0,0,0,0
"SJ Chalmers ",2009,2009,2,2,0,0,0,0,0,0
"BS Chandrasekhar ",1976,1976,1,1,0,0,0,0,0,0
"VB Chandrasekhar ",1988,1990,7,7,0,0,0,0,0,0
"CJD Chappell ",1979,1979,3,3,0,0,0,0,0,0
"G Chapple ",2006,2006,1,1,0,0,0,0,0,0
"M Cheruparambil ",2004,2004,2,2,0,0,0,0,0,0
"MT Chinouya ",2013,2013,2,2,0,0,0,0,0,0
"K Christie ",2016,2016,1,1,0,0,0,0,0,0
"WM Clark ",1978,1978,2,2,0,0,0,0,0,0
"A Codrington ",2003,2007,9,9,0,0,0,0,0,0
"DJ Colley ",1972,1972,1,1,0,0,0,0,0,0
"BE Congdon ",1973,1978,11,11,0,0,0,0,0,0
"AN Connolly ",1971,1971,1,1,0,0,0,0,0,0
"GA Cope ",1977,1978,2,2,0,0,0,0,0,0
"MJ Cosgrove ",2006,2006,3,3,0,0,0,0,0,0
"CS Cowdrey ",1985,1985,3,3,0,0,0,0,0,0
"MC Cowdrey ",1971,1971,1,1,0,0,0,0,0,0
"RT Crandon ",2009,2009,1,1,0,0,0,0,0,0
"FS Crockwell ",2009,2009,2,2,0,0,0,0,0,0
"SM Curran ",2018,2020,4,4,0,0,0,0,0,0
"SS Das ",2001,2002,4,4,0,0,0,0,0,0
"NA David ",1997,1997,4,4,0,0,0,0,0,0
"RR David ",2008,2010,4,4,0,0,0,0,0,0
"H Davids ",2013,2013,2,1,0,0,0,0,0,0
"SG Davies ",1996,1996,4,4,0,0,0,0,0,0
"IC Davis ",1974,1977,3,3,0,0,0,0,0,0
"Dawlat Ahmadzai ",2009,2010,3,3,0,0,0,0,0,0
"JJ Dawood ",2009,2010,2,1,0,0,0,0,0,0
"LA Dawson ",2016,2018,3,2,0,0,0,0,0,0
"NA de Groot ",2003,2003,6,6,0,0,0,0,0,0
"M de Lange ",2012,2016,4,4,0,0,0,0,0,0
"GJ Delany ",2020,2020,2,2,0,0,0,0,0,0
"FA Dennis ",1979,1979,3,3,0,0,0,0,0,0
"GN de Silva ",1983,1985,4,4,0,0,0,0,0,0
"JI de Villiers ",2020,2020,2,2,0,0,0,0,0,0
"P Dharmani ",1996,1996,1,1,0,0,0,0,0,0
"R Dhawan ",2016,2016,3,3,0,0,0,0,0,0
"HS Dhillon ",2006,2006,2,2,0,0,0,0,0,0
"WP Diepeveen ",2011,2011,1,1,0,0,0,0,0,0
"Dolar Mahmud ",2008,2009,7,7,0,0,0,0,0,0
"BR Dorey ",2006,2006,4,4,0,0,0,0,0,0
"CRM Douglas ",2008,2008,2,2,0,0,0,0,0,0
"SO Dowrich ",2019,2019,1,1,0,0,0,0,0,0
"S Dube ",2019,2019,1,1,0,0,0,0,0,0
"BM Duckett ",2016,2016,3,3,0,0,0,0,0,0
"DM Dupavillon ",2020,2020,1,1,0,0,0,0,0,0
"N Dutta ",2013,2013,1,1,0,0,0,0,0,0
"PS Eaglestone ",2008,2008,1,1,0,0,0,0,0,0
"JH Edrich ",1971,1975,7,7,0,0,0,0,0,0
"R Edwards ",1972,1975,9,9,0,0,0,0,0,0
"WJ Edwards ",1975,1975,1,1,0,0,0,0,0,0
"Ehsanul Haque ",2002,2003,6,6,0,0,0,0,0,0
"Ehsan Adil ",2013,2015,6,6,0,0,0,0,0,0
"Elias Sunny ",2011,2012,4,4,0,0,0,0,0,0
"MTG Elliott ",1997,1997,1,1,0,0,0,0,0,0
"Fahad Alhashmi ",2008,2015,5,5,0,0,0,0,0,0
"Fahad Nawaz ",2019,2019,2,2,0,0,0,0,0,0
"Faisal Athar ",2003,2003,1,1,0,0,0,0,0,0
"Fawad Ahmed ",2013,2013,3,3,0,0,0,0,0,0
"Fayyaz Ahmed ",2014,2016,3,3,0,0,0,0,0,0
"FY Fazal ",2016,2016,1,1,0,0,0,0,0,0
"Fazl-e-Akbar ",1998,2001,2,2,0,0,0,0,0,0
"N Fernandes ",2008,2008,1,1,0,0,0,0,0,0
"AM Fernando ",2017,2017,1,1,0,0,0,0,0,0
"ER Fernando ",1975,1975,3,3,0,0,0,0,0,0
"ERNS Fernando ",1983,1983,7,7,0,0,0,0,0,0
"MVT Fernando ",2017,2019,8,8,0,0,0,0,0,0
"TL Fernando ",1989,1989,1,1,0,0,0,0,0,0
"UNK Fernando ",1994,1994,2,2,0,0,0,0,0,0
"R Flannigan ",2010,2010,1,1,0,0,0,0,0,0
"DAG Fletcher ",1983,1983,6,6,0,0,0,0,0,0
"MLC Foster ",1973,1973,2,2,0,0,0,0,0,0
"TJ Franklin ",1983,1988,3,3,0,0,0,0,0,0
"Frasat Ali ",1975,1975,3,3,0,0,0,0,0,0
"IS Gallage ",1999,2001,3,3,0,0,0,0,0,0
"DJ Gandhi ",1999,2000,3,3,0,0,0,0,0,0
"D Ganesh ",1997,1997,1,1,0,0,0,0,0,0
"LV Garrick ",2001,2001,3,3,0,0,0,0,0,0
"WT Gavera ",2014,2017,4,4,0,0,0,0,0,0
"RS Ghai ",1984,1986,6,6,0,0,0,0,0,0
"Gholam Nousher ",1986,1990,9,9,0,0,0,0,0,0
"Ghulam Ali ",1993,1995,3,3,0,0,0,0,0,0
"T Gibbons ",2006,2006,2,2,0,0,0,0,0,0
"LR Gibbs ",1973,1975,3,3,0,0,0,0,0,0
"PG Gillespie ",2006,2007,5,5,0,0,0,0,0,0
"Golam Faruq ",1986,1990,5,5,0,0,0,0,0,0
"MS Gony ",2008,2008,2,2,0,0,0,0,0,0
"Y Goonasekera ",1983,1983,3,3,0,0,0,0,0,0
"JOA Gordon ",2012,2014,5,5,0,0,0,0,0,0
"EL Gouka ",1996,1996,3,3,0,0,0,0,0,0
"VD Grandia ",2002,2002,1,1,0,0,0,0,0,0
"AE Greenidge ",1978,1978,1,1,0,0,0,0,0,0
"RD Gudhka ",2011,2011,2,2,0,0,0,0,0,0
"FRMD Gunatilleke ",1979,1979,1,1,0,0,0,0,0,0
"AAW Gunawardena ",1994,1994,1,1,0,0,0,0,0,0
"SK Gupta ",1996,2001,10,10,0,0,0,0,0,0
"Gurdeep Singh ",2013,2013,1,1,0,0,0,0,0,0
"Haafiz Shahid ",1988,1988,3,3,0,0,0,0,0,0
"BG Hadlee ",1975,1975,2,2,0,0,0,0,0,0
"OJ Hairs ",2010,2010,5,5,0,0,0,0,0,0
"JD Hall ",2010,2010,3,3,0,0,0,0,0,0
"LJ Hamilton ",2005,2005,2,2,0,0,0,0,0,0
"JR Hammond ",1972,1972,1,1,0,0,0,0,0,0
"JH Hampshire ",1971,1972,3,3,0,0,0,0,0,0
"Hamza Tahir ",2019,2019,6,6,0,0,0,0,0,0
"Harilal Shah ",1975,1975,3,3,0,0,0,0,0,0
"RT Hart ",1985,1985,1,1,0,0,0,0,0,0
"Harunur Rashid ",1988,1988,2,2,0,0,0,0,0,0
"SM Harwood ",2009,2009,1,1,0,0,0,0,0,0
"MJ Haslam ",1992,1992,1,1,0,0,0,0,0,0
"Hasti Gul ",2009,2009,2,2,0,0,0,0,0,0
"FC Hayes ",1973,1975,6,5,0,0,0,0,0,0
"RL Hayes ",1995,1995,1,1,0,0,0,0,0,0
"RGA Headley ",1973,1973,1,1,0,0,0,0,0,0
"SD Heazlett ",2017,2017,1,1,0,0,0,0,0,0
"R Hekure ",2019,2019,1,1,0,0,0,0,0,0
"CW Henderson ",2001,2001,4,4,0,0,0,0,0,0
"CC Henry ",1979,1979,2,2,0,0,0,0,0,0
"H Hiri ",2016,2019,7,7,0,0,0,0,0,0
"VR Hogg ",1983,1983,2,2,0,0,0,0,0,0
"RG Holland ",1985,1985,2,2,0,0,0,0,0,0
"DAW Hollis ",2008,2008,1,1,0,0,0,0,0,0
"PA Horne ",1987,1987,4,4,0,0,0,0,0,0
"Hussain Talat ",2019,2019,1,1,0,0,0,0,0,0
"Ilyas Gull ",2004,2004,2,2,0,0,0,0,0,0
"Intikhab Alam ",1973,1976,4,4,0,0,0,0,0,0
"Iqbal Sikander ",1992,1992,4,4,0,0,0,0,0,0
"Irfan Fazil ",2000,2000,1,1,0,0,0,0,0,0
"Irfan Sajid ",2014,2014,1,1,0,0,0,0,0,0
"Ishtiaq Muhammad ",2016,2016,1,1,0,0,0,0,0,0
"W Jaffer ",2006,2006,2,2,0,0,0,0,0,0
"Jahangir Alam Talukdar ",1990,1990,2,2,0,0,0,0,0,0
"JA Jameson ",1973,1975,3,3,0,0,0,0,0,0
"Jasdeep Singh ",2019,2019,4,4,0,0,0,0,0,0
"Jawahir Shah ",1975,1975,3,3,0,0,0,0,0,0
"PS Jayaprakashdaran ",2005,2005,1,1,0,0,0,0,0,0
"RSA Jayasekera ",1982,1982,2,2,0,0,0,0,0,0
"NGRP Jayasuriya ",2018,2018,2,2,0,0,0,0,0,0
"TJ Jenner ",1975,1975,1,1,0,0,0,0,0,0
"KCB Jeremy ",2000,2001,6,6,0,0,0,0,0,0
"K Jethi ",2008,2008,3,3,0,0,0,0,0,0
"HR Johnson ",2004,2004,2,2,0,0,0,0,0,0
"RL Johnson ",2003,2003,10,9,0,0,0,0,0,0
"RA Jones ",2003,2003,5,5,0,0,0,0,0,0
"SP Jones ",2004,2005,8,8,0,0,0,0,0,0
"C Jonker ",2018,2018,2,2,0,0,0,0,0,0
"S Jora ",2019,2019,1,1,0,0,0,0,0,0
"D Joseph ",2003,2003,4,4,0,0,0,0,0,0
"Junaid Siddique ",2019,2020,6,6,0,0,0,0,0,0
"Junaid Zia ",2003,2003,4,4,0,0,0,0,0,0
"R Kaia ",2015,2015,1,1,0,0,0,0,0,0
"AV Kale ",2003,2003,1,1,0,0,0,0,0,0
"LWS Kaluperuma ",1975,1982,4,4,0,0,0,0,0,0
"Kamran Hussain ",2008,2008,2,2,0,0,0,0,0,0
"K Kamyuka ",2013,2013,2,2,0,0,0,0,0,0
"AL Kandappah ",2007,2007,2,2,0,0,0,0,0,0
"Karan KC ",2018,2020,9,9,0,0,0,0,0,0
"Karim Janat ",2017,2017,1,1,0,0,0,0,0,0
"Kashif Raza ",2001,2001,1,1,0,0,0,0,0,0
"F Kasteni ",2007,2007,3,3,0,0,0,0,0,0
"E Katchay ",2008,2009,5,5,0,0,0,0,0,0
"PHT Kaushal ",2015,2015,1,1,0,0,0,0,0,0
"RWT Key ",2003,2004,5,5,0,0,0,0,0,0
"Khalid Khan ",2004,2004,2,2,0,0,0,0,0,0
"Khaliq Dad ",2009,2010,6,6,0,0,0,0,0,0
"GK Khoda ",1998,1998,2,2,0,0,0,0,0,0
"JP Kotze ",2019,2020,8,8,0,0,0,0,0,0
"CK Kruger ",2008,2008,2,2,0,0,0,0,0,0
"SC Kuggeleijn ",2017,2017,2,2,0,0,0,0,0,0
"Kushal Malla ",2020,2020,3,3,0,0,0,0,0,0
"MKGCP Lakshitha ",2002,2003,7,7,0,0,0,0,0,0
"AV Lalcheta ",2019,2019,2,2,0,0,0,0,0,0
"SB Lama ",2004,2004,1,1,0,0,0,0,0,0
"GA Lamb ",2010,2011,15,15,0,0,0,0,0,0
"CB Lambert ",1990,2004,12,12,0,0,0,0,0,0
"TJ Laughlin ",1978,1979,6,6,0,0,0,0,0,0
"DV Lawrence ",1991,1991,1,1,0,0,0,0,0,0
"JJC Lawson ",2001,2005,13,12,0,0,0,0,0,0
"J Lewis ",2005,2007,13,13,0,0,0,0,0,0
"Liaqat Ali ",1977,1978,3,3,0,0,0,0,0,0
"GFJ Liebenberg ",1995,1998,4,4,0,0,0,0,0,0
"JB Little ",2019,2019,4,4,0,0,0,0,0,0
"TA Lloyd ",1984,1984,3,3,0,0,0,0,0,0
"CH Lonsdale ",2007,2007,1,1,0,0,0,0,0,0
"AGR Loudon ",2006,2006,1,1,0,0,0,0,0,0
"J Louw ",2008,2008,3,3,0,0,0,0,0,0
"MB Loye ",2007,2007,7,7,0,0,0,0,0,0
"BW Luckhurst ",1975,1975,3,3,0,0,0,0,0,0
"C McAuslan ",2017,2017,2,2,0,0,0,0,0,0
"OC McCoy ",2018,2018,2,2,0,0,0,0,0,0
"JA Maclean ",1979,1979,2,1,0,0,0,0,0,0
"H McLeod ",1975,1975,2,2,0,0,0,0,0,0
"NJ MacRae ",2006,2006,2,2,0,0,0,0,0,0
"DSK Madushanka ",2018,2018,1,1,0,0,0,0,0,0
"LD Madushanka ",2017,2017,4,4,0,0,0,0,0,0
"Mahbubur Rahman ",1999,1999,1,1,0,0,0,0,0,0
"S Mahmood ",2020,2020,1,1,0,0,0,0,0,0
"Mahmood Hamid ",1995,1995,1,1,0,0,0,0,0,0
"DJ Malan ",2019,2019,1,1,0,0,0,0,0,0
"AV Mankad ",1974,1974,1,1,0,0,0,0,0,0
"Mansoor Amjad ",2008,2008,1,1,0,0,0,0,0,0
"Mansoor Rana ",1990,1990,2,2,0,0,0,0,0,0
"Maqsood Rana ",1990,1990,1,1,0,0,0,0,0,0
"CA Marshall ",1979,1979,2,2,0,0,0,0,0,0
"JAH Marshall ",2005,2008,10,10,0,0,0,0,0,0
"GC Martin ",1994,1995,5,5,0,0,0,0,0,0
"Masood Iqbal ",1984,1984,1,1,0,0,0,0,0,0
"SJ Massiah ",2004,2004,2,2,0,0,0,0,0,0
"PS Masvaure ",2018,2018,2,2,0,0,0,0,0,0
"AW Mathieson ",2015,2015,1,1,0,0,0,0,0,0
"BM Mauricette ",1979,1979,3,3,0,0,0,0,0,0
"DES Maxwell ",2006,2007,10,10,0,0,0,0,0,0
"Mazharul Haque ",2002,2002,1,1,0,0,0,0,0,0
"GJ McCarter ",2014,2014,1,1,0,0,0,0,0,0
"SC Meaker ",2011,2011,2,2,0,0,0,0,0,0
"Mehmood Quaraishy ",1975,1975,3,3,0,0,0,0,0,0
"PS Mehta ",1975,1975,1,1,0,0,0,0,0,0
"MA Meman ",1987,1987,1,1,0,0,0,0,0,0
"PHKD Mendis ",2019,2019,2,2,0,0,0,0,0,0
"JM Mennie ",2016,2016,2,2,0,0,0,0,0,0
"PL Mhambrey ",1996,1998,3,3,0,0,0,0,0,0
"Mohammad Abbas ",2019,2019,3,3,0,0,0,0,0,0
"Mohammad Aslam ",1996,1996,4,4,0,0,0,0,0,0
"Mohammad Iqbal ",2007,2008,5,5,0,0,0,0,0,0
"Mohammad Nazir ",1980,1984,4,4,0,0,0,0,0,0
"Mohammad Talha ",2014,2014,3,3,0,0,0,0,0,0
"Mohammed Siraj ",2019,2019,1,1,0,0,0,0,0,0
"Moin-ul-Atiq ",1988,1989,5,5,0,0,0,0,0,0
"Moniruzzaman ",2003,2003,2,2,0,0,0,0,0,0
"DWO Morgan ",2006,2006,2,2,0,0,0,0,0,0
"EA Moseley ",1990,1991,9,8,0,0,0,0,0,0
"PV Mpitsang ",1999,1999,2,2,0,0,0,0,0,0
"Mujahid Jamshed ",1997,1997,4,4,0,0,0,0,0,0
"M Mulla ",2007,2007,1,1,0,0,0,0,0,0
"AMN Munasinghe ",1994,1996,5,5,0,0,0,0,0,0
"Munir Dar ",2008,2008,2,2,0,0,0,0,0,0
"GB Murgatroyd ",2003,2003,6,6,0,0,0,0,0,0
"DJ Murray ",1994,1994,1,1,0,0,0,0,0,0
"T Muzarabani ",2015,2016,8,8,0,0,0,0,0,0
"Nadeem Ghauri ",1990,1990,6,6,0,0,0,0,0,0
"Nadeem Khan ",1993,1995,2,2,0,0,0,0,0,0
"Naeem Ashraf ",1995,1995,2,2,0,0,0,0,0,0
"J Nagenda ",1975,1975,1,1,0,0,0,0,0,0
"SS Naik ",1974,1974,2,2,0,0,0,0,0,0
"KK Nair ",2016,2016,2,2,0,0,0,0,0,0
"Najaf Shah ",2007,2007,1,1,0,0,0,0,0,0
"Najeeb Tarakai ",2017,2017,1,1,0,0,0,0,0,0
"DP Nannes ",2009,2009,1,1,0,0,0,0,0,0
"Naseer Malik ",1975,1975,3,3,0,0,0,0,0,0
"Nasim-ul-Ghani ",1973,1973,1,1,0,0,0,0,0,0
"Nasir Aziz ",2014,2015,5,5,0,0,0,0,0,0
"Nasir Hameed ",2004,2004,1,1,0,0,0,0,0,0
"Nasir Javed ",2004,2004,1,1,0,0,0,0,0,0
"Naumanullah ",2008,2008,1,1,0,0,0,0,0,0
"Naved Anjum ",1984,1992,13,13,0,0,0,0,0,0
"MN Nawaz ",1998,2002,3,3,0,0,0,0,0,0
"AM Nayar ",2009,2009,3,3,0,0,0,0,0,0
"N Ncube ",2011,2011,1,1,0,0,0,0,0,0
"A Ndlovu ",2019,2019,2,2,0,0,0,0,0,0
"MG Neser ",2018,2018,2,2,0,0,0,0,0,0
"SO Ngoche ",2010,2014,14,14,0,0,0,0,0,0
"IA Nicolson ",2010,2010,2,2,0,0,0,0,0,0
"RG Nijman ",2009,2009,1,1,0,0,0,0,0,0
"AA Noffke ",2008,2008,1,1,0,0,0,0,0,0
"Nurul Abedin ",1986,1990,4,4,0,0,0,0,0,0
"KJ O'Keeffe ",1977,1977,2,2,0,0,0,0,0,0
"D Olivier ",2019,2019,2,2,0,0,0,0,0,0
"DR O'Sullivan ",1974,1976,3,3,0,0,0,0,0,0
"MB Owens ",1992,1992,1,1,0,0,0,0,0,0
"M Panchal ",2007,2007,1,1,0,0,0,0,0,0
"GK Pandey ",1999,1999,2,2,0,0,0,0,0,0
"BA Parchment ",2007,2008,7,7,0,0,0,0,0,0
"MW Parkinson ",2020,2020,2,2,0,0,0,0,0,0
"SD Parry ",2014,2014,2,2,0,0,0,0,0,0
"Parvez Rasool ",2014,2014,1,1,0,0,0,0,0,0
"NT Pascal ",2009,2009,1,1,0,0,0,0,0,0
"SP Pasqual ",1979,1979,2,2,0,0,0,0,0,0
"A Patel ",2003,2003,2,2,0,0,0,0,0,0
"JM Patel ",1979,1979,3,3,0,0,0,0,0,0
"KA Patel ",2006,2006,2,2,0,0,0,0,0,0
"ML Patel ",2004,2006,3,3,0,0,0,0,0,0
"RGM Patel ",1988,1988,1,1,0,0,0,0,0,0
"R Pathan ",2013,2013,1,1,0,0,0,0,0,0
"BMW Patterson ",1999,1999,3,3,0,0,0,0,0,0
"GE Peckover ",1983,1983,3,3,0,0,0,0,0,0
"KG Perera ",1986,1986,1,1,0,0,0,0,0,0
"N Phillip ",1978,1978,1,1,0,0,0,0,0,0
"HSM Pieris ",1975,1975,3,3,0,0,0,0,0,0
"K Pierre ",2019,2020,3,3,0,0,0,0,0,0
"ADJ Pitcher ",2007,2007,3,3,0,0,0,0,0,0
"PI Pocock ",1985,1985,1,1,0,0,0,0,0,0
"DJ Pringle ",1975,1975,2,2,0,0,0,0,0,0
"CA Pujara ",2013,2014,5,4,0,0,0,0,0,0
"Y Punja ",2015,2015,1,1,0,0,0,0,0,0
"M Pushpakumara ",2009,2010,3,2,0,0,0,0,0,0
"CT Radley ",1978,1978,4,4,0,0,0,0,0,0
"Rafiqul Alam ",1986,1986,2,2,0,0,0,0,0,0
"Rafiqul Islam ",2002,2002,1,1,0,0,0,0,0,0
"RR Ramdass ",2005,2005,1,1,0,0,0,0,0,0
"D Ramnarine ",1997,2001,4,4,0,0,0,0,0,0
"DR Ramsammy ",2012,2012,1,1,0,0,0,0,0,0
"Ramveer Rai ",2004,2004,1,1,0,0,0,0,0,0
"AN Ranasinghe ",1975,1982,9,9,0,0,0,0,0,0
"N Ranatunga ",1993,1993,2,2,0,0,0,0,0,0
"Randhir Singh ",1981,1983,2,2,0,0,0,0,0,0
"Rashid Zia ",2004,2004,2,2,0,0,0,0,0,0
"NLK Ratnayake ",1989,1990,2,2,0,0,0,0,0,0
"SS Raul ",1998,1998,2,2,0,0,0,0,0,0
"Raza Hasan ",2014,2014,1,1,0,0,0,0,0,0
"RE Redmond ",1973,1973,2,2,0,0,0,0,0,0
"B Regmi ",2018,2019,4,4,0,0,0,0,0,0
"CA Reid ",2004,2004,2,2,0,0,0,0,0,0
"RA Reifer ",2019,2019,2,2,0,0,0,0,0,0
"CEB Rice ",1991,1991,3,3,0,0,0,0,0,0
"EJ Richardson ",2013,2013,2,2,0,0,0,0,0,0
"EB Ringera ",2011,2011,1,1,0,0,0,0,0,0
"HP Rinke ",2006,2006,18,18,0,0,0,0,0,0
"Rizwan Latif ",2004,2004,1,1,0,0,0,0,0,0
"SJ Roberts ",1990,1990,2,2,0,0,0,0,0,0
"Robiul Islam ",2013,2013,3,3,0,0,0,0,0,0
"TS Roland-Jones ",2017,2017,1,1,0,0,0,0,0,0
"Saad Ali ",2019,2019,2,2,0,0,0,0,0,0
"Saad Nasim ",2015,2015,3,3,0,0,0,0,0,0
"Sagar Pun ",2018,2018,1,1,0,0,0,0,0,0
"Saiful Islam ",1990,1997,7,7,0,0,0,0,0,0
"Sajjad Ahmed ",1995,1995,2,2,0,0,0,0,0,0
"Sajjad Akbar ",1990,1990,2,2,0,0,0,0,0,0
"Saleem Pervez ",1980,1980,1,1,0,0,0,0,0,0
"Saleem Raza ",1994,1996,6,6,0,0,0,0,0,0
"Salman Faris ",2014,2014,3,3,0,0,0,0,0,0
"Salman Farooq ",2014,2014,1,1,0,0,0,0,0,0
"Samiullah Khan ",2008,2008,2,2,0,0,0,0,0,0
"Sami Aslam ",2015,2016,4,4,0,0,0,0,0,0
"Sami Faridi ",2008,2008,3,3,0,0,0,0,0,0
"GS Sandhu ",2015,2015,2,2,0,0,0,0,0,0
"Saqib Zulfiqar ",2019,2019,1,1,0,0,0,0,0,0
"P Sarraf ",2019,2019,2,2,0,0,0,0,0,0
"Sayed Shirzad ",2019,2019,2,1,0,0,0,0,0,0
"RH Scholte ",2002,2003,5,5,0,0,0,0,0,0
"BN Schultz ",1992,1992,1,1,0,0,0,0,0,0
"GR Sealy ",1979,1979,3,3,0,0,0,0,0,0
"TAP Sekhar ",1983,1985,4,4,0,0,0,0,0,0
"Shafiuddin Ahmed ",1997,2000,11,11,0,0,0,0,0,0
"Shaheedur Rahman ",1986,1986,2,2,0,0,0,0,0,0
"Shahid Anwar ",1996,1996,1,1,0,0,0,0,0,0
"Shehzad Altaf ",1996,1996,2,2,0,0,0,0,0,0
"Shahzad Khan ",2007,2007,1,1,0,0,0,0,0,0
"Shahzaib Hasan ",2010,2010,3,3,0,0,0,0,0,0
"Shakeel Ahmed jnr ",1995,1995,2,2,0,0,0,0,0,0
"Shakeel Khan ",1987,1987,1,1,0,0,0,0,0,0
"A Shamshudeen ",2007,2007,1,1,0,0,0,0,0,0
"JNK Shannon ",2013,2013,1,1,0,0,0,0,0,0
"Shariful Haque ",1998,1998,1,1,0,0,0,0,0,0
"PH Sharma ",1976,1976,2,2,0,0,0,0,0,0
"PP Shaw ",2020,2020,3,3,0,0,0,0,0,0
"AP Sheahan ",1972,1972,3,3,0,0,0,0,0,0
"Sheikh Salahuddin ",1997,1997,6,6,0,0,0,0,0,0
"V Shetty ",2008,2014,2,2,0,0,0,0,0,0
"M Shezi ",2014,2014,1,1,0,0,0,0,0,0
"S Shivnarine ",1978,1978,1,1,0,0,0,0,0,0
"Shubman Gill ",2019,2019,2,2,0,0,0,0,0,0
"Shuvagata Hom ",2011,2011,4,4,0,0,0,0,0,0
"JD Siddons ",1988,1988,1,1,0,0,0,0,0,0
"EHSN Silva ",2008,2008,1,1,0,0,0,0,0,0
"KJ Silva ",1995,1995,1,1,0,0,0,0,0,0
"CEW Silverwood ",1996,2001,7,7,0,0,0,0,0,0
"Simandeep Singh ",2018,2018,1,1,0,0,0,0,0,0
"RP Singh ",1986,1986,2,2,0,0,0,0,0,0
"Skhawat Ali ",2008,2014,4,4,0,0,0,0,0,0
"WN Slack ",1986,1986,2,2,0,0,0,0,0,0
"CL Smith ",1984,1984,4,4,0,0,0,0,0,0
"DM Smith ",1986,1990,2,2,0,0,0,0,0,0
"M Smith ",2008,2008,1,1,0,0,0,0,0,0
"MJ Smith ",1999,1999,5,5,0,0,0,0,0,0
"RAJ Smith ",2016,2016,2,2,0,0,0,0,0,0
"G Snyman ",2003,2003,5,5,0,0,0,0,0,0
"Sohail Butt ",1994,1994,2,2,0,0,0,0,0,0
"S Somasunder ",1996,1996,2,2,0,0,0,0,0,0
"TE Srinivasan ",1980,1981,2,2,0,0,0,0,0,0
"RW Staple ",2004,2004,2,2,0,0,0,0,0,0
"NA Statham ",2003,2009,3,3,0,0,0,0,0,0
"MP Stead ",1979,1979,2,2,0,0,0,0,0,0
"RD Steede ",2006,2008,8,8,0,0,0,0,0,0
"DS Steele ",1976,1976,1,1,0,0,0,0,0,0
"SL Stewart ",2010,2010,4,4,0,0,0,0,0,0
"PJR Steyn ",1995,1995,1,1,0,0,0,0,0,0
"OP Stone ",2018,2018,4,3,0,0,0,0,0,0
"Subashis Roy ",2016,2016,1,1,0,0,0,0,0,0
"Sultan Ahmed ",2019,2019,2,2,0,0,0,0,0,0
"GP Sulzberger ",2000,2000,3,3,0,0,0,0,0,0
"S Sumar ",1975,1975,1,1,0,0,0,0,0,0
"Sunzamul Islam ",2017,2018,3,3,0,0,0,0,0,0
"SJ Swanepoel ",2003,2003,5,5,0,0,0,0,0,0
"Tabarak Dar ",2004,2008,4,4,0,0,0,0,0,0
"AR Tait ",1998,1999,5,5,0,0,0,0,0,0
"Tanvir Mehdi ",1992,1992,1,1,0,0,0,0,0,0
"Tariq Javed ",1979,1979,3,3,0,0,0,0,0,0
"JP Taylor ",1993,1993,1,1,0,0,0,0,0,0
"LB Taylor ",1986,1986,2,2,0,0,0,0,0,0
"DJ Terbrugge ",2000,2000,4,4,0,0,0,0,0,0
"DJ ter Braak ",2018,2018,2,2,0,0,0,0,0,0
"VAB Tewarie ",2011,2011,1,1,0,0,0,0,0,0
"JG Thomas ",1986,1987,3,3,0,0,0,0,0,0
"O Thomas ",2018,2020,20,19,0,0,0,0,0,0
"EP Thompson ",2009,2009,1,1,0,0,0,0,0,0
"PIC Thompson ",1997,1997,2,2,0,0,0,0,0,0
"AL Thomson ",1971,1971,1,1,0,0,0,0,0,0
"MH Tissera ",1975,1975,3,3,0,0,0,0,0,0
"GC Tonge ",2009,2009,5,5,0,0,0,0,0,0
"PM Toohey ",1978,1979,5,4,0,0,0,0,0,0
"GS Trimble ",1986,1986,2,2,0,0,0,0,0,0
"MS Tshabalala ",2007,2007,4,4,0,0,0,0,0,0
"CK Tshuma ",2020,2020,2,2,0,0,0,0,0,0
"CM Tuckett ",1998,1998,1,1,0,0,0,0,0,0
"ML Udawatte ",2008,2008,9,9,0,0,0,0,0,0
"JD Unadkat ",2013,2013,7,7,0,0,0,0,0,0
"Usman Mushtaq ",2015,2015,1,1,0,0,0,0,0,0
"T van der Gugten ",2012,2013,4,4,0,0,0,0,0,0
"MG Vandort ",2006,2006,1,1,0,0,0,0,0,0
"PA van Meekeren ",2013,2019,5,5,0,0,0,0,0,0
"MWA van Nierop ",2006,2006,2,2,0,0,0,0,0,0
"KJJ van Noortwijk ",1996,2003,9,9,0,0,0,0,0,0
"BO van Rooi ",2003,2003,3,3,0,0,0,0,0,0
"RJ van Vuuren ",2003,2003,5,5,0,0,0,0,0,0
"CJPG van Zyl ",1992,1992,2,2,0,0,0,0,0,0
"JCB Vaughan ",1979,1979,3,3,0,0,0,0,0,0
"M Venkataramana ",1988,1988,1,1,0,0,0,0,0,0
"GE Vivian ",1973,1973,1,1,0,0,0,0,0,0
"DM Vonhagt ",1985,1985,1,1,0,0,0,0,0,0
"Wahidul Gani ",1988,1988,1,1,0,0,0,0,0,0
"KP Walmsley ",2003,2003,2,2,0,0,0,0,0,0
"R Walters ",2003,2003,2,2,0,0,0,0,0,0
"S Walusimbi ",1975,1975,3,3,0,0,0,0,0,0
"Waqas Khan ",2015,2017,8,8,0,0,0,0,0,0
"Wasim Haider ",1992,1992,3,3,0,0,0,0,0,0
"SL Watkin ",1994,1994,4,4,0,0,0,0,0,0
"M Watkinson ",1996,1996,1,1,0,0,0,0,0,0
"GD Watson ",1972,1972,2,2,0,0,0,0,0,0
"RJ Webb ",1983,1983,3,3,0,0,0,0,0,0
"AP Weerakkody ",1994,1994,1,1,0,0,0,0,0,0
"S Weerakoon ",2012,2012,2,2,0,0,0,0,0,0
"AP Wells ",1995,1995,1,1,0,0,0,0,0,0
"CM Wells ",1985,1985,2,2,0,0,0,0,0,0
"MD Wettimuny ",1983,1983,1,1,0,0,0,0,0,0
"SRD Wettimuny ",1975,1979,3,3,0,0,0,0,0,0
"K Whatham ",2011,2011,1,1,0,0,0,0,0,0
"DF Whatmore ",1980,1980,1,1,0,0,0,0,0,0
"RK Whelan ",2007,2007,2,2,0,0,0,0,0,0
"RPAH Wickramaratne ",1993,1993,3,3,0,0,0,0,0,0
"D Wiese ",2015,2016,6,6,0,0,0,0,0,0
"KOK Williams ",2017,2018,8,8,0,0,0,0,0,0
"JG Williamson ",1999,1999,2,2,0,0,0,0,0,0
"CM Willoughby ",2000,2003,3,3,0,0,0,0,0,0
"AJ Woodcock ",1974,1974,1,1,0,0,0,0,0,0
"LJ Woodcock ",2011,2011,4,4,0,0,0,0,0,0
"T Yohannan ",2002,2002,3,3,0,0,0,0,0,0
"Yunus Badat ",1975,1975,2,2,0,0,0,0,0,0
"Zafar Gohar ",2015,2015,1,1,0,0,0,0,0,0
"Zaheer Maqsood ",2015,2015,2,2,0,0,0,0,0,0
"Zahid Ahmed ",1987,1987,2,2,0,0,0,0,0,0
"Zahid Razzak ",1988,1990,3,3,0,0,0,0,0,0
"Zahid Shah ",2008,2008,2,2,0,0,0,0,0,0
"MZ Zahir ",2009,2009,1,1,0,0,0,0,0,0
"Zahir Khan ",2019,2019,1,1,0,0,0,0,0,0
"Zain Abbas ",2008,2008,1,1,0,0,0,0,0,0
"Zakir Hasan ",1997,1997,1,1,0,0,0,0,0,0
"Zakir Hossain ",1998,1998,1,1,0,0,0,0,0,0
"Zakir Khan ",1984,1990,17,16,0,0,0,0,0,0
"Zakiullah Zaki ",2012,2012,1,1,0,0,0,0,0,0
"Zawar Farid ",2020,2020,1,1,0,0,0,0,0,0
"Zeeshan Siddiqi ",2012,2014,2,2,0,0,0,0,0,0
"Zulfiqar Babar ",2014,2015,5,5,0,0,0,0,0,0
"BC Fortuin ",2020,2020,1,NA,NA,NA,NA,NA,NA,NA
