"","Player","Start","End","Matches","Innings","Dismissals","Caught","CaughtFielder","CaughtBehind","Stumped","MaxDismissalsInnings"
"1","KC Sangakkara ",2000,2015,404,397,501,402,19,383,99,5
"2","AC Gilchrist ",1996,2008,287,286,472,417,0,417,55,6
"3","MS Dhoni ",2004,2019,350,345,444,321,0,321,123,6
"4","MV Boucher ",1998,2011,295,291,425,403,1,402,22,6
"5","Moin Khan ",1990,2004,219,217,287,214,0,214,73,5
"6","BB McCullum ",2002,2016,260,257,277,262,35,227,15,5
"7","IA Healy ",1988,1997,168,168,233,194,0,194,39,4
"8","Mushfiqur Rahim ",2006,2020,218,217,225,181,2,179,44,5
"9","Rashid Latif ",1992,2003,166,164,220,182,0,182,38,5
"10","DPMD Jayawardene ",1998,2015,448,443,218,218,218,0,0,4
"11","R Dravid ",1996,2011,344,341,210,196,124,72,14,4
"12","RS Kaluwitharana ",1990,2004,189,188,207,132,1,131,75,5
"13","PJL Dujon ",1981,1991,169,168,204,183,0,183,21,4
"14","JC Buttler ",2012,2019,142,138,202,171,0,171,31,6
"15","RD Jacobs ",1996,2004,147,145,189,160,0,160,29,6
"16","Kamran Akmal ",2002,2017,157,154,188,157,1,156,31,5
"17","D Ramdin ",2005,2016,139,137,188,181,0,181,7,5
"18","AB de Villiers ",2005,2018,228,223,181,176,83,93,5,5
"19","BJ Haddin ",2001,2015,126,124,181,170,0,170,11,5
"20","AJ Stewart ",1989,2003,170,169,174,159,11,148,15,6
"21","Q de Kock ",2013,2020,121,116,173,164,0,164,9,6
"22","A Flower ",1992,2003,213,212,173,141,8,133,32,5
"23","DJ Richardson ",1991,1998,122,121,165,148,0,148,17,5
"24","RT Ponting ",1995,2012,375,372,160,160,160,0,0,3
"25","M Azharuddin ",1985,2000,334,332,156,156,156,0,0,4
"26","NR Mongia ",1994,2000,140,139,154,110,0,110,44,5
"27","BRM Taylor ",2004,2020,196,196,154,125,29,96,29,5
"28","T Taibu ",2001,2012,150,150,147,114,2,112,33,4
"29","AC Parore ",1992,2002,179,178,141,116,5,111,25,5
"30","Sarfaraz Ahmed ",2007,2019,116,114,140,116,0,116,24,6
"31","SR Tendulkar ",1989,2012,463,456,140,140,140,0,0,4
"32","LRPL Taylor ",2006,2020,232,228,139,139,139,0,0,4
"33","Younis Khan ",2000,2015,265,260,135,135,130,5,0,4
"34","SP Fleming ",1994,2007,280,276,133,133,133,0,0,4
"35","JH Kallis ",1996,2014,328,324,131,131,131,0,0,3
"36","M Muralitharan ",1993,2011,350,347,130,130,130,0,0,3
"37","V Kohli ",2008,2020,248,246,128,128,128,0,0,3
"38","AR Border ",1979,1994,273,270,127,127,127,0,0,3
"39","Shahid Afridi ",1996,2015,398,392,127,127,127,0,0,2
"40","Khaled Mashud ",1995,2006,126,126,126,91,0,91,35,5
"41","TM Dilshan ",1999,2016,330,325,124,123,118,5,1,3
"42","CH Gayle ",1999,2019,301,294,124,124,124,0,0,3
"43","RW Marsh ",1971,1984,92,92,124,120,0,120,4,5
"44","ST Jayasuriya ",1989,2011,445,441,123,123,123,0,0,3
"45","CL Hooper ",1987,2003,227,225,120,120,120,0,0,4
"46","BC Lara ",1990,2007,299,296,120,120,120,0,0,3
"47","L Ronchi ",2008,2017,85,83,117,105,0,105,12,4
"48","MS Wade ",2012,2017,94,94,117,108,0,108,9,5
"49","Inzamam-ul-Haq ",1991,2007,378,373,113,113,113,0,0,3
"50","SR Waugh ",1986,2002,325,324,111,111,111,0,0,3
"51","RS Mahanama ",1986,1999,213,212,109,109,109,0,0,3
"52","PD Collingwood ",2001,2011,197,197,108,108,108,0,0,3
"53","HH Gibbs ",1996,2010,248,246,108,108,108,0,0,3
"54","SM Pollock ",1996,2008,303,300,108,108,108,0,0,2
"55","ME Waugh ",1988,2002,244,243,108,108,108,0,0,3
"56","MJ Clarke ",2003,2015,245,243,106,106,106,0,0,4
"57","MEK Hussey ",2004,2012,185,184,105,105,105,0,0,3
"58","JN Rhodes ",1992,2003,245,242,105,105,105,0,0,5
"59","GC Smith ",2002,2013,197,196,105,105,105,0,0,4
"60","NJ O'Brien ",2006,2018,103,99,104,90,8,82,14,5
"61","Saleem Yousuf ",1982,1990,86,86,103,81,0,81,22,4
"62","SK Raina ",2005,2018,226,223,102,102,102,0,0,3
"63","SC Ganguly ",1992,2007,311,309,100,100,100,0,0,3
"64","IVA Richards ",1975,1991,187,186,100,100,100,0,0,3
"65","Shoaib Malik ",1999,2019,287,285,98,98,98,0,0,2
"66","CZ Harris ",1990,2004,250,247,96,96,96,0,0,4
"67","PA de Silva ",1984,2003,308,307,95,95,95,0,0,3
"68","HP Tillakaratne ",1986,2003,200,199,95,89,50,39,6,5
"69","Yuvraj Singh ",2000,2017,304,298,94,94,94,0,0,3
"70","SD Hope ",2016,2020,78,75,93,83,0,83,10,5
"71","V Sehwag ",1999,2013,251,246,93,93,93,0,0,3
"72","MJ Guptill ",2009,2020,183,181,91,91,91,0,0,4
"73","Ijaz Ahmed ",1986,2000,250,249,90,90,90,0,0,3
"74","KS More ",1984,1993,94,93,90,63,0,63,27,5
"75","Umar Akmal ",2009,2019,121,119,90,77,32,45,13,5
"76","TWM Latham ",2012,2020,99,97,89,82,26,56,7,5
"77","Mohammad Shahzad ",2009,2019,84,83,89,64,1,63,25,5
"78","DL Vettori ",1997,2015,295,289,88,88,88,0,0,2
"79","Wasim Akram ",1984,2003,356,352,88,88,88,0,0,3
"80","HM Amla ",2008,2019,181,176,87,87,87,0,0,4
"81","GW Flower ",1992,2010,221,220,86,86,86,0,0,2
"82","IDS Smith ",1980,1992,98,97,86,81,1,80,5,3
"83","A Kumble ",1990,2007,271,268,85,85,85,0,0,2
"84","Mohammad Hafeez ",2003,2019,218,216,85,85,85,0,0,2
"85","NJ Astle ",1995,2007,223,219,83,83,83,0,0,3
"86","EJG Morgan ",2006,2020,236,230,83,83,80,3,0,3
"87","GC Wilson ",2007,2019,105,101,83,73,24,49,10,4
"88","JP Duminy ",2004,2019,199,195,82,82,82,0,0,3
"89","A Symonds ",1998,2009,198,196,82,82,82,0,0,4
"90","F du Plessis ",2011,2019,143,141,81,81,81,0,0,3
"91","Saleem Malik ",1982,1999,283,277,81,81,80,1,0,4
"92","SK Warne ",1993,2005,194,193,80,80,80,0,0,3
"93","UDU Chandana ",1994,2007,147,146,79,79,79,0,0,3
"94","MJ Prior ",2004,2011,68,68,79,71,2,69,8,6
"95","RG Sharma ",2007,2020,224,223,77,77,77,0,0,3
"96","ADR Campbell ",1992,2003,188,187,76,76,74,2,0,3
"97","MH Cross ",2014,2019,52,51,75,71,0,71,4,6
"98","RB Richardson ",1983,1996,224,222,75,75,75,0,0,4
"99","JE Root ",2013,2020,146,142,74,74,74,0,0,3
"100","JC Adams ",1992,2001,127,127,73,68,42,26,5,5
"101","DJ Bravo ",2004,2014,164,161,73,73,73,0,0,3
"102","S Chanderpaul ",1994,2011,268,264,73,73,73,0,0,2
"103","WJ Cronje ",1992,2000,188,186,73,73,73,0,0,2
"104","Javed Miandad ",1975,1996,233,229,73,71,70,1,2,3
"105","SB Styris ",1999,2011,188,185,73,73,73,0,0,3
"106","E Chigumbura ",2004,2018,213,212,72,72,72,0,0,4
"107","GO Jones ",2004,2014,51,51,72,68,0,68,4,5
"108","Harbhajan Singh ",1998,2015,236,231,71,71,71,0,0,3
"109","N Kapil Dev ",1978,1994,225,222,71,71,71,0,0,3
"110","KD Karthik ",2004,2019,94,94,71,64,29,35,7,4
"111","H Masakadza ",2001,2019,209,209,71,71,71,0,0,2
"112","MS Atapattu ",1990,2007,268,266,70,70,70,0,0,3
"113","MG Bevan ",1994,2004,232,230,69,69,69,0,0,3
"114","DR Martyn ",1992,2006,208,205,69,69,69,0,0,3
"115","A Bagai ",2003,2013,62,62,68,59,1,58,9,4
"116","CO Browne ",1995,2005,46,46,68,59,0,59,9,5
"117","ML Hayden ",1993,2008,161,158,68,68,68,0,0,2
"118","DJG Sammy ",2004,2015,126,124,67,67,67,0,0,3
"119","SPD Smith ",2010,2020,125,125,67,67,67,0,0,3
"120","SO Tikolo ",1996,2014,135,135,67,67,67,0,0,3
"121","CL Cairns ",1991,2006,215,214,66,66,66,0,0,3
"122","LD Chandimal ",2010,2019,146,143,66,59,28,31,7,4
"123","MD Crowe ",1982,1995,143,141,66,66,66,0,0,3
"124","Misbah-ul-Haq ",2002,2015,162,160,66,66,66,0,0,4
"125","C Kieswetter ",2010,2013,46,45,65,53,1,52,12,5
"126","GJ Maxwell ",2012,2019,110,110,65,65,65,0,0,4
"127","GA Hick ",1991,2001,120,119,64,64,64,0,0,3
"128","Mahmudullah ",2007,2020,188,187,64,64,64,0,0,3
"129","KJ O'Brien ",2006,2020,145,141,64,64,64,0,0,3
"130","WTS Porterfield ",2006,2020,139,134,64,64,64,0,0,3
"131","SR Watson ",2002,2015,190,189,64,64,64,0,0,2
"132","A Ranatunga ",1982,1999,269,268,63,63,63,0,0,3
"133","DJ Cullinan ",1993,2000,138,135,62,62,62,0,0,3
"134","S Dhawan ",2010,2020,136,134,62,62,62,0,0,4
"135","G Kirsten ",1993,2003,185,183,62,61,60,1,1,3
"136","Mashrafe Mortaza ",2001,2020,220,220,62,62,62,0,0,2
"137","NLTC Perera ",2009,2020,164,160,62,62,62,0,0,2
"138","Wasim Bari ",1973,1984,51,50,62,52,0,52,10,4
"139","AL Logie ",1981,1993,158,158,61,61,61,0,0,3
"140","DA Miller ",2010,2020,132,128,61,61,61,0,0,3
"141","KA Pollard ",2007,2020,113,111,61,61,61,0,0,4
"142","AJ Finch ",2013,2020,126,126,60,60,60,0,0,3
"143","WPUJC Vaas ",1994,2008,322,320,60,60,60,0,0,2
"144","KS Williamson ",2010,2020,151,150,60,60,60,0,0,3
"145","DL Haynes ",1978,1994,238,236,59,59,59,0,0,2
"146","A Jadeja ",1992,2000,196,195,59,59,59,0,0,2
"147","RA Jadeja ",2009,2020,165,164,58,58,58,0,0,2
"148","Mohammad Yousuf ",1998,2010,288,285,58,58,58,0,0,2
"149","MA Ouma ",2004,2014,80,80,58,48,5,43,10,5
"150","KO Otieno ",1996,2009,90,90,57,43,3,40,14,4
"151","AJ Strauss ",2003,2011,127,127,57,57,57,0,0,3
"152","MA Taylor ",1989,1997,113,113,56,56,56,0,0,4
"153","RA Harper ",1983,1996,105,105,55,55,55,0,0,3
"154","M Kaif ",2002,2006,125,122,55,55,55,0,0,4
"155","Mohammad Nabi ",2009,2019,124,121,55,55,55,0,0,3
"156","TD Paine ",2009,2018,35,34,55,51,0,51,4,5
"157","PV Simmons ",1987,1999,143,143,55,55,55,0,0,4
"158","DA Warner ",2009,2020,123,123,55,55,55,0,0,2
"159","IR Bell ",2004,2015,161,160,54,54,54,0,0,3
"160","DM Jones ",1984,1994,164,164,54,54,54,0,0,2
"161","B Lee ",2000,2012,221,217,54,54,54,0,0,3
"162","Tamim Iqbal ",2007,2020,207,206,54,54,54,0,0,2
"163","JM Anderson ",2002,2015,194,192,53,53,53,0,0,3
"164","AD Mathews ",2008,2020,217,213,53,53,53,0,0,3
"165","JR Murray ",1992,1999,55,55,53,46,2,44,7,3
"166","AB Agarkar ",1998,2007,191,188,52,52,52,0,0,2
"167","CS Baugh ",2003,2012,47,46,51,39,0,39,12,4
"168","JDP Oram ",2001,2012,160,159,51,51,51,0,0,2
"169","JG Wright ",1978,1992,149,147,51,51,51,0,0,2
"170","JO Holder ",2013,2020,115,112,50,50,50,0,0,2
"171","MN Samuels ",2000,2018,207,207,50,50,50,0,0,2
"172","Shakib Al Hasan ",2006,2019,206,205,50,50,50,0,0,3
"173","WU Tharanga ",2005,2019,235,228,50,50,50,0,0,3
"174","P Utseya ",2004,2015,164,164,50,50,50,0,0,2
"175","SC Williams ",2005,2020,133,132,50,50,50,0,0,3
"176","Aamer Sohail ",1990,2000,156,154,49,49,49,0,0,2
"177","AP Gurusinha ",1985,1996,147,147,49,49,47,2,0,2
"178","WB Phillips ",1982,1986,48,48,49,42,0,42,7,4
"179","ME Trescothick ",2000,2006,123,121,49,49,45,4,0,3
"180","KC Wessels ",1983,1994,109,106,49,49,49,0,0,4
"181","RP Arnold ",1997,2007,180,179,48,48,48,0,0,2
"182","GJ Bailey ",2012,2016,90,90,48,48,48,0,0,3
"183","AM Rahane ",2011,2018,90,87,48,48,48,0,0,2
"184","J Smits ",2003,2009,38,38,48,41,0,41,7,4
"185","AT Carey ",2018,2020,36,36,47,42,0,42,5,5
"186","N Dickwella ",2014,2019,52,52,47,38,0,38,9,4
"187","A Flintoff ",1999,2009,141,140,47,47,47,0,0,3
"188","RC Russell ",1987,1998,40,40,47,41,0,41,6,3
"189","KMDN Kulasekara ",2003,2017,184,181,46,46,46,0,0,3
"190","MDKJ Perera ",2013,2020,101,100,46,43,17,26,3,4
"191","HH Streak ",1993,2005,189,188,46,46,46,0,0,2
"192","CEL Ambrose ",1988,2000,176,175,45,45,45,0,0,3
"193","DC Boon ",1984,1995,181,181,45,45,45,0,0,2
"194","GA Gooch ",1976,1995,125,125,45,45,45,0,0,2
"195","CG Greenidge ",1975,1991,128,127,45,45,45,0,0,2
"196","RR Sarwan ",2000,2013,181,176,45,45,45,0,0,2
"197","PR Stirling ",2008,2020,117,113,45,45,45,0,0,3
"198","BA Stokes ",2011,2019,95,92,45,45,45,0,0,3
"199","D Williams ",1988,1997,36,35,45,35,0,35,10,4
"200","DI Gower ",1978,1991,114,114,44,44,44,0,0,3
"201","NV Knight ",1996,2003,100,100,44,44,44,0,0,2
"202","CD McMillan ",1997,2007,197,193,44,44,44,0,0,2
"203","DO Obuya ",2001,2012,74,74,44,39,16,23,5,4
"204","CR Woakes ",2011,2020,101,97,44,44,44,0,0,4
"205","Z Khan ",2000,2012,200,197,43,43,43,0,0,3
"206","CO Obuya ",2001,2014,104,104,43,43,43,0,0,3
"207","RL Powell ",1999,2005,109,107,43,43,43,0,0,3
"208","CMW Read ",2000,2006,36,35,43,41,0,41,2,5
"209","CR Ervine ",2010,2019,93,92,42,42,42,0,0,4
"210","BM McMillan ",1991,1998,78,77,42,42,42,0,0,3
"211","KD Mills ",2001,2015,170,169,42,42,42,0,0,3
"212","Saeed Anwar ",1989,2003,247,242,42,42,42,0,0,3
"213","V Sibanda ",2003,2016,127,127,42,42,42,0,0,2
"214","K Srikkanth ",1981,1992,146,145,42,42,42,0,0,2
"215","GP Thorpe ",1993,2002,82,81,42,42,42,0,0,3
"216","NL McCullum ",2009,2015,84,83,41,41,41,0,0,4
"217","KR Rutherford ",1985,1995,121,121,41,41,41,0,0,4
"218","L Vincent ",2001,2007,102,100,41,41,39,2,0,2
"219","JV Coney ",1979,1987,88,86,40,40,40,0,0,3
"220","N Hussain ",1989,2003,88,88,40,40,40,0,0,2
"221","KP Pietersen ",2004,2013,136,135,40,40,40,0,0,2
"222","Saqlain Mushtaq ",1995,2003,169,166,40,40,40,0,0,2
"223","RJ Shastri ",1981,1992,150,148,40,40,40,0,0,2
"224","Sikandar Raza ",2013,2020,100,99,40,40,40,0,0,3
"225","SV Carlisle ",1995,2005,111,111,39,39,39,0,0,3
"226","VVS Laxman ",1998,2006,86,85,39,39,39,0,0,4
"227","CH Lloyd ",1973,1985,87,87,39,39,39,0,0,3
"228","BKG Mendis ",2016,2020,76,75,39,39,37,2,0,3
"229","PA Patel ",2003,2012,38,36,39,30,0,30,9,4
"230","TG Southee ",2008,2020,143,142,39,39,39,0,0,3
"231","TE Blain ",1986,1994,38,38,38,37,1,36,1,4
"232","DSBP Kuruppu ",1983,1990,54,54,38,30,4,26,8,4
"233","DL Murray ",1973,1980,26,26,38,37,0,37,1,4
"234","HDRL Thirimanne ",2010,2019,127,125,38,38,38,0,0,2
"235","Azhar Mahmood ",1996,2007,143,140,37,37,37,0,0,2
"236","JM Bairstow ",2011,2020,77,74,37,35,22,13,2,4
"237","AG Cremer ",2009,2018,96,95,37,37,37,0,0,2
"238","GD McGrath ",1993,2007,250,248,37,37,37,0,0,3
"239","S Matsikenyeri ",2002,2015,113,113,37,37,37,0,0,3
"240","Najibullah Zadran ",2012,2019,67,66,37,37,37,0,0,3
"241","BKV Prasad ",1994,2001,161,160,37,37,37,0,0,3
"242","Sabbir Rahman ",2014,2019,66,65,37,37,37,0,0,3
"243","RG Twose ",1995,2001,87,87,37,37,37,0,0,2
"244","DB Vengsarkar ",1976,1991,129,127,37,37,37,0,0,3
"245","CL White ",2005,2018,91,90,37,37,37,0,0,3
"246","Babar Azam ",2015,2019,74,73,36,36,36,0,0,2
"247","J Botha ",2005,2012,78,77,36,36,36,0,0,3
"248","IT Botham ",1976,1992,116,116,36,36,36,0,0,2
"249","AN Cook ",2006,2014,92,91,36,36,36,0,0,2
"250","HH Dippenaar ",1999,2007,107,106,36,36,34,2,0,3
"251","GH Dockrell ",2010,2019,87,85,36,36,36,0,0,2
"252","G Gambhir ",2003,2013,147,144,36,36,36,0,0,3
"253","GB Hogg ",1996,2008,123,121,36,36,36,0,0,2
"254","Imran Khan ",1974,1992,175,172,36,36,36,0,0,3
"255","SMH Kirmani ",1976,1986,49,48,36,27,0,27,9,5
"256","GJ Whittall ",1993,2003,147,146,36,36,36,0,0,4
"257","Abdul Razzaq ",1996,2011,265,262,35,35,35,0,0,2
"258","RS Bopara ",2007,2015,120,118,35,35,35,0,0,2
"259","MJ Greatbatch ",1988,1996,84,84,35,35,34,1,0,2
"260","MG Johnson ",2005,2015,153,152,35,35,35,0,0,2
"261","L Klusener ",1996,2004,171,169,35,35,35,0,0,2
"262","Mohammad Ashraful ",2001,2013,177,177,35,35,35,0,0,2
"263","Waqar Younis ",1989,2003,262,259,35,35,35,0,0,2
"264","DM Bravo ",2009,2020,113,110,34,34,34,0,0,3
"265","HDPK Dharmasena ",1994,2004,141,140,34,34,34,0,0,2
"266","Nasir Hossain ",2011,2018,65,65,34,34,34,0,0,2
"267","PL Taylor ",1987,1992,83,83,34,34,34,0,0,2
"268","N Boje ",1995,2005,115,113,33,33,33,0,0,2
"269","RW Chakabva ",2008,2020,41,41,33,29,12,17,4,5
"270","CJ Chibhabha ",2005,2020,104,103,33,33,33,0,0,2
"271","NH Fairbrother ",1987,1999,75,75,33,33,33,0,0,3
"272","KM Jadhav ",2014,2020,73,72,33,33,33,0,0,3
"273","RS Kalpage ",1992,1999,86,86,33,33,33,0,0,3
"274","JM Kemp ",2001,2007,85,84,33,33,33,0,0,3
"275","Ramiz Raja ",1985,1997,198,193,33,33,33,0,0,2
"276","RR Singh ",1989,2001,136,135,33,33,33,0,0,2
"277","CJO Smith ",2006,2009,27,26,33,22,0,22,11,5
"278","Soumya Sarkar ",2014,2019,55,54,33,33,33,0,0,4
"279","Abdur Razzak ",2004,2014,153,153,32,32,32,0,0,2
"280","MM Ali ",2014,2020,102,99,32,32,32,0,0,3
"281","Ghulam Shabber ",2017,2019,23,23,32,30,0,30,2,4
"282","J Srinath ",1991,2003,229,227,32,32,32,0,0,2
"283","RW Taylor ",1973,1984,27,27,32,26,0,26,6,4
"284","TA Boult ",2012,2020,90,90,31,31,31,0,0,2
"285","DL Houghton ",1983,1997,63,63,31,29,19,10,2,4
"286","CK Kapugedera ",2006,2017,102,100,31,31,31,0,0,2
"287","AJ Lamb ",1982,1992,122,122,31,31,31,0,0,2
"288","SL Malinga ",2004,2019,226,220,31,31,31,0,0,2
"289","GR Marsh ",1986,1992,117,117,31,31,31,0,0,2
"290","M Morkel ",2007,2018,117,114,31,31,31,0,0,3
"291","JJ Roy ",2015,2020,87,85,31,31,31,0,0,2
"292","DR Smith ",2004,2015,105,103,31,31,31,0,0,2
"293","R Ashwin ",2010,2017,111,110,30,30,30,0,0,3
"294","RG de Alwis ",1983,1988,31,31,30,27,0,27,3,5
"295","J Garner ",1977,1987,98,98,30,30,30,0,0,3
"296","LK Germon ",1994,1997,37,37,30,21,0,21,9,4
"297","MA Holding ",1976,1987,102,102,30,30,30,0,0,3
"298","SS Karim ",1997,2000,34,34,30,27,0,27,3,4
"299","WK Lees ",1979,1983,31,31,30,28,0,28,2,4
"300","CS MacLeod ",2008,2019,66,65,30,30,30,0,0,4
"301","Mohammad Rizwan ",2015,2019,32,32,30,29,12,17,1,4
"302","Mushtaq Ahmed ",1989,2003,144,144,30,30,30,0,0,2
"303","M Ntini ",1998,2009,173,171,30,30,30,0,0,2
"304","CS Pandit ",1986,1992,36,36,30,15,0,15,15,4
"305","AU Rashid ",2009,2020,100,97,30,30,30,0,0,3
"306","PA Strang ",1994,2001,95,94,30,30,30,0,0,2
"307","Aftab Ahmed ",2004,2010,85,85,29,29,29,0,0,3
"308","TM Alderman ",1981,1991,65,65,29,29,29,0,0,3
"309","Alok Kapali ",2002,2011,69,69,29,29,29,0,0,2
"310","RD Berrington ",2008,2019,78,77,29,29,29,0,0,2
"311","PR Downton ",1977,1988,28,28,29,26,0,26,3,4
"312","AJ Hall ",1999,2007,88,87,29,29,29,0,0,2
"313","WW Hinds ",1999,2010,119,119,29,29,29,0,0,2
"314","DJ Hussey ",2008,2013,69,69,29,29,29,0,0,2
"315","R Mutumbami ",2014,2020,36,36,29,24,2,22,5,4
"316","GP Swann ",2000,2013,79,78,29,29,29,0,0,3
"317","DC Thomas ",2009,2013,21,21,29,23,0,23,6,3
"318","Ahmed Shehzad ",2009,2017,81,80,28,28,28,0,0,2
"319","PW Borren ",2006,2014,58,58,28,28,28,0,0,3
"320","JJ Crowe ",1983,1990,75,74,28,28,28,0,0,2
"321","AA Donald ",1991,2003,164,162,28,28,28,0,0,2
"322","GC Dyer ",1986,1988,23,23,28,24,0,24,4,4
"323","GJ Hopkins ",2004,2010,25,23,28,27,0,27,1,5
"324","Mohammad Rafique ",1995,2007,125,125,28,28,28,0,0,2
"325","TM Odoyo ",1996,2014,136,136,28,28,28,0,0,2
"326","RJ Peterson ",2002,2014,79,79,28,28,28,0,0,2
"327","LMP Simmons ",2006,2015,68,68,28,28,26,2,0,2
"328","DW Steyn ",2005,2019,125,124,28,28,28,0,0,2
"329","BA Young ",1990,1999,74,73,28,28,22,6,0,3
"330","KLT Arthurton ",1988,1999,105,104,27,27,27,0,0,2
"331","F Behardien ",2013,2018,59,58,27,27,27,0,0,2
"332","SCJ Broad ",2006,2016,121,121,27,27,27,0,0,2
"333","CRD Fernando ",2001,2012,147,146,27,27,27,0,0,3
"334","Sir RJ Hadlee ",1973,1990,115,113,27,27,27,0,0,2
"335","AD Hales ",2014,2019,70,68,27,27,27,0,0,2
"336","KJ Hughes ",1977,1985,97,96,27,27,27,0,0,2
"337","EC Joyce ",2006,2018,78,75,27,27,27,0,0,2
"338","B Kumar ",2012,2019,114,113,27,27,27,0,0,2
"339","Liton Das ",2015,2020,36,36,27,24,16,8,3,4
"340","CJ McDermott ",1985,1996,138,138,27,27,27,0,0,1
"341","MR Marsh ",2011,2020,57,57,27,27,27,0,0,4
"342","Mohammed Shami ",2013,2020,77,76,27,27,27,0,0,2
"343","M Prabhakar ",1984,1996,130,128,27,27,27,0,0,3
"344","MJ Santner ",2015,2020,72,71,27,27,27,0,0,2
"345","MA Starc ",2010,2020,91,91,27,27,27,0,0,2
"346","Wahab Riaz ",2008,2019,89,88,27,27,27,0,0,2
"347","CA Walsh ",1985,2000,205,204,27,27,27,0,0,1
"348","NW Bracken ",2001,2009,116,116,26,26,26,0,0,2
"349","PAJ DeFreitas ",1987,1997,103,103,26,26,26,0,0,2
"350","JEC Franklin ",2001,2013,110,109,26,26,26,0,0,2
"351","Habibul Bashar ",1995,2007,111,111,26,26,26,0,0,2
"352","Imran Nazir ",1999,2009,79,78,26,26,26,0,0,3
"353","DS Lehmann ",1996,2005,117,116,26,26,26,0,0,3
"354","MF Maharoof ",2004,2016,109,107,26,26,26,0,0,2
"355","LE Plunkett ",2005,2019,89,87,26,26,26,0,0,2
"356","AG Prince ",2002,2007,52,51,26,26,26,0,0,4
"357","RA Smith ",1988,1996,71,71,26,26,26,0,0,2
"358","GP Wickramasinghe ",1990,2002,134,134,26,26,26,0,0,2
"359","CB Wishart ",1996,2005,90,90,26,26,26,0,0,2
"360","B Zuiderent ",1996,2011,57,57,26,26,26,0,0,2
"361","W Barresi ",2010,2019,32,32,25,17,4,13,8,3
"362","D Gough ",1994,2006,159,157,25,25,25,0,0,1
"363","JR Hopes ",2005,2010,84,83,25,25,25,0,0,2
"364","Imran Tahir ",2011,2019,107,104,25,25,25,0,0,2
"365","DT Johnston ",2006,2013,67,65,25,25,25,0,0,2
"366","DJ Nash ",1992,2002,81,80,25,25,25,0,0,3
"367","DW Randall ",1976,1985,49,49,25,25,25,0,0,2
"368","PR Reiffel ",1992,1999,92,92,25,25,25,0,0,2
"369","Saeed Ajmal ",2008,2015,113,112,25,25,25,0,0,1
"370","MP Vaughan ",2001,2007,86,85,25,25,25,0,0,3
"371","Aaqib Javed ",1988,1998,163,159,24,24,24,0,0,1
"372","Asghar Afghan ",2009,2019,111,108,24,24,24,0,0,2
"373","V Dahiya ",2000,2001,19,19,24,19,0,19,5,3
"374","SS Dighe ",2000,2001,23,23,24,19,0,19,5,4
"375","NM Hauritz ",2002,2011,58,57,24,24,24,0,0,2
"376","S Viswanath ",1985,1988,22,22,24,17,0,17,7,5
"377","Wasim Raja ",1973,1985,54,52,24,24,24,0,0,2
"378","M Amarnath ",1975,1989,85,84,23,23,23,0,0,2
"379","SL Campbell ",1994,2001,90,90,23,23,23,0,0,3
"380","GS Chappell ",1971,1983,74,72,23,23,23,0,0,2
"381","DD Ebrahim ",2001,2005,82,82,23,23,23,0,0,2
"382","AH Jones ",1987,1995,87,87,23,23,23,0,0,2
"383","Junaid Siddique ",2007,2011,54,54,23,23,22,1,0,3
"384","GR Larsen ",1990,1999,121,121,23,23,23,0,0,1
"385","S Lee ",1995,2001,45,44,23,23,23,0,0,2
"386","SV Manjrekar ",1988,1996,74,74,23,23,23,0,0,2
"387","GRJ Matthews ",1984,1993,59,59,23,23,23,0,0,3
"388","PJ Moor ",2014,2019,49,48,23,22,6,16,1,4
"389","JDS Neesham ",2013,2020,63,63,23,23,23,0,0,2
"390","PA Nixon ",2007,2007,19,19,23,20,0,20,3,2
"391","DN Patel ",1987,1997,75,75,23,23,23,0,0,2
"392","SW Poynter ",2014,2019,21,21,23,22,3,19,1,4
"393","PL Symcox ",1993,1999,80,80,23,23,23,0,0,2
"394","TJ Zoehrer ",1986,1994,22,22,23,21,0,21,2,4
"395","Zulqarnain ",1985,1989,16,14,23,18,0,18,5,4
"396","Afsar Zazai ",2014,2017,17,16,22,20,0,20,2,3
"397","J Charles ",2012,2016,48,48,22,21,11,10,1,2
"398","MW Gatting ",1977,1993,92,92,22,22,22,0,0,2
"399","SM Gavaskar ",1974,1987,108,107,22,22,22,0,0,4
"400","AF Giles ",1997,2005,62,62,22,22,22,0,0,3
"401","SE Marsh ",2008,2019,73,73,22,22,22,0,0,2
"402","PL Mommsen ",2010,2017,44,43,22,22,22,0,0,2
"403","C Munro ",2013,2019,57,57,22,22,22,0,0,2
"404","SP O'Donnell ",1985,1991,87,87,22,22,22,0,0,2
"405","HH Pandya ",2016,2019,54,53,22,22,22,0,0,2
"406","K Rabada ",2015,2019,75,73,22,22,22,0,0,2
"407","Rashid Khan ",2015,2019,71,68,22,22,22,0,0,3
"408","RR Rossouw ",2014,2016,36,35,22,22,22,0,0,4
"409","MN Waller ",2009,2018,79,79,22,22,22,0,0,1
"410","RGD Willis ",1973,1984,64,64,22,22,22,0,0,2
"411","UT Yadav ",2010,2018,75,73,22,22,22,0,0,3
"412","Abdul Qadir ",1983,1993,104,102,21,21,21,0,0,2
"413","DL Bairstow ",1979,1984,21,21,21,17,0,17,4,3
"414","Fakhar Zaman ",2017,2019,46,45,21,21,21,0,0,2
"415","JP Faulkner ",2013,2017,69,69,21,21,21,0,0,1
"416","Imrul Kayes ",2008,2018,78,78,21,21,21,0,0,2
"417","ND McKenzie ",2000,2009,64,64,21,21,21,0,0,3
"418","Manzoor Elahi ",1984,1995,54,54,21,21,21,0,0,2
"419","AF Milne ",2012,2017,40,39,21,21,21,0,0,3
"420","D Mongia ",2001,2007,57,56,21,21,21,0,0,3
"421","TM Moody ",1987,1999,76,76,21,21,21,0,0,2
"422","Mudassar Nazar ",1977,1989,122,119,21,21,21,0,0,2
"423","A Nel ",2001,2008,79,77,21,21,21,0,0,2
"424","IK Pathan ",2004,2012,120,118,21,21,21,0,0,1
"425","MSK Prasad ",1998,1999,17,17,21,14,0,14,7,5
"426","KAJ Roach ",2008,2019,92,90,21,21,21,0,0,2
"427","Samiullah Shinwari ",2009,2019,84,84,21,21,21,0,0,2
"428","OA Shah ",2001,2009,71,71,21,21,21,0,0,2
"429","RV Uthappa ",2006,2015,46,44,21,19,15,4,2,3
"430","AR White ",2006,2014,61,61,21,21,21,0,0,2
"431","AR Whittall ",1996,2000,63,63,21,21,21,0,0,3
"432","DJ Willey ",2015,2019,46,45,21,21,21,0,0,2
"433","Ashraf Ali ",1980,1985,16,16,20,17,0,17,3,3
"434","A Balbirnie ",2010,2020,67,65,20,20,20,0,0,4
"435","GB Brent ",1996,2008,70,70,20,20,20,0,0,2
"436","TT Bresnan ",2006,2015,85,84,20,20,20,0,0,2
"437","AF Buurman ",2007,2011,17,17,20,17,2,15,3,3
"438","CK Coventry ",2003,2015,39,39,20,19,19,0,1,1
"439","DN Crookes ",1994,2000,32,32,20,20,20,0,0,2
"440","DM de Silva ",2016,2020,45,45,20,20,20,0,0,2
"441","M Dillon ",1997,2005,108,107,20,20,20,0,0,2
"442","JS Foster ",2001,2002,11,11,20,13,0,13,7,3
"443","MW Goodwin ",1998,2000,71,71,20,20,20,0,0,2
"444","JK Kamande ",1999,2011,86,86,20,20,20,0,0,2
"445","H Klaasen ",2018,2020,17,17,20,17,6,11,3,4
"446","CC Lewis ",1990,1998,53,53,20,20,20,0,0,2
"447","DA Minors ",2006,2007,20,20,20,16,4,12,4,3
"448","RS Morton ",2002,2010,56,55,20,20,20,0,0,3
"449","Rubel Hossain ",2009,2019,101,100,20,20,20,0,0,2
"450","Salman Butt ",2004,2010,78,77,20,20,20,0,0,2
"451","Shoaib Akhtar ",1998,2011,163,162,20,20,20,0,0,2
"452","NS Sidhu ",1987,1998,136,135,20,20,20,0,0,2
"453","LPC Silva ",1999,2011,75,73,20,20,20,0,0,3
"454","SAR Silva ",1984,1985,20,20,20,17,0,17,3,3
"455","JE Taylor ",2003,2017,90,88,20,20,20,0,0,2
"456","DR Tuffey ",2000,2010,94,92,20,20,20,0,0,3
"457","BJ Watling ",2010,2018,28,28,20,20,6,14,0,3
"458","Akram Raza ",1989,1995,49,49,19,19,19,0,0,2
"459","AJ Bichel ",1997,2004,67,66,19,19,19,0,0,2
"460","JG Bracewell ",1983,1990,53,52,19,19,19,0,0,3
"461","BL Cairns ",1974,1985,78,77,19,19,19,0,0,2
"462","EJ Chatfield ",1979,1989,114,112,19,19,19,0,0,2
"463","SS Cottrell ",2015,2020,35,33,19,19,19,0,0,3
"464","XJ Doherty ",2010,2015,60,60,19,19,19,0,0,2
"465","JE Emburey ",1980,1993,61,61,19,19,19,0,0,2
"466","JM How ",2005,2011,41,40,19,19,19,0,0,4
"467","NC Johnson ",1998,2000,48,48,19,19,19,0,0,2
"468","CJ Jordan ",2013,2020,34,34,19,19,19,0,0,2
"469","SB Joshi ",1996,2001,69,68,19,19,19,0,0,2
"470","RAS Lakmal ",2009,2019,85,83,19,19,19,0,0,1
"471","AR McBrine ",2014,2020,45,44,19,19,19,0,0,3
"472","Mohammad Sami ",2001,2015,87,86,19,19,19,0,0,2
"473","JF Mooney ",2006,2015,64,62,19,19,19,0,0,2
"474","DK Morrison ",1987,1996,96,96,19,19,19,0,0,2
"475","Naeem Islam ",2008,2014,59,59,19,19,19,0,0,2
"476","Nawroz Mangal ",2009,2016,49,49,19,19,19,0,0,2
"477","CJ Nevin ",2000,2003,37,36,19,16,2,14,3,3
"478","Rahmat Shah ",2013,2019,73,70,19,19,19,0,0,2
"479","SMSM Senanayake ",2012,2015,49,48,19,19,19,0,0,3
"480","I Sharma ",2007,2016,80,78,19,19,19,0,0,1
"481","MC Snedden ",1980,1990,93,92,19,19,19,0,0,1
"482","AO Suji ",1996,2008,60,60,19,19,19,0,0,2
"483","V Yadav ",1992,1994,19,19,19,12,0,12,7,3
"484","Asif Mujtaba ",1986,1996,66,66,18,18,18,0,0,3
"485","AR Cusack ",2007,2015,59,55,18,18,18,0,0,2
"486","PG Fulton ",2004,2009,49,48,18,18,18,0,0,2
"487","IJ Gould ",1983,1983,18,18,18,15,0,15,3,3
"488","SO Hetmyer ",2017,2020,45,43,18,18,15,3,0,3
"489","AC Hudson ",1991,1997,89,88,18,18,18,0,0,2
"490","AN Kervezee ",2006,2012,39,39,18,18,18,0,0,3
"491","GF Lawson ",1980,1989,79,79,18,18,18,0,0,2
"492","MA Leask ",2014,2019,34,34,18,18,18,0,0,3
"493","S Madan Lal ",1974,1987,67,65,18,18,18,0,0,2
"494","RS Madugalle ",1979,1988,63,63,18,18,18,0,0,2
"495","JP Maher ",1998,2003,26,26,18,18,10,8,0,3
"496","Maninder Singh ",1983,1993,59,58,18,18,18,0,0,2
"497","HJH Marshall ",2003,2007,66,65,18,18,18,0,0,3
"498","NO Miller ",2008,2018,50,48,18,18,18,0,0,3
"499","A Nehra ",2001,2011,120,120,18,18,18,0,0,2
"500","HM Nicholls ",2015,2020,49,48,18,18,18,0,0,2
"501","RR Patel ",2008,2014,39,39,18,18,18,0,0,2
"502","Raqibul Hasan ",2008,2011,55,55,18,18,18,0,0,2
"503","WP Saha ",2010,2014,9,8,18,17,0,17,1,4
"504","SA Thomson ",1990,1996,56,56,18,18,18,0,0,2
"505","MA Vermeulen ",2000,2009,43,43,18,18,18,0,0,3
"506","DP Viljoen ",1997,2001,53,53,18,18,18,0,0,2
"507","SC Williams ",1994,1999,57,57,18,18,18,0,0,3
"508","LJ Wright ",2007,2014,50,50,18,18,18,0,0,2
"509","Ahmed Raza ",2014,2020,31,31,17,17,17,0,0,3
"510","JJ Bumrah ",2016,2020,64,64,17,17,17,0,0,2
"511","JM Davison ",2003,2011,32,32,17,17,17,0,0,2
"512","GD Elliott ",2008,2016,83,83,17,17,17,0,0,2
"513","TJ Friend ",2000,2004,51,51,17,17,17,0,0,2
"514","Haris Sohail ",2013,2019,41,40,17,17,17,0,0,2
"515","IJ Harvey ",1997,2004,73,72,17,17,17,0,0,2
"516","MJ Henry ",2014,2019,52,50,17,17,17,0,0,2
"517","Khaled Mahmud ",1998,2006,77,77,17,17,17,0,0,2
"518","E Lewis ",2016,2020,51,49,17,17,17,0,0,2
"519","EB McSweeney ",1986,1987,16,15,17,14,0,14,3,3
"520","PJ Ongondo ",1999,2011,79,79,17,17,17,0,0,2
"521","YK Pathan ",2008,2012,57,56,17,17,17,0,0,3
"522","RW Price ",2002,2012,102,102,17,17,17,0,0,2
"523","WB Rankin ",2007,2020,75,73,17,17,17,0,0,2
"524","AT Rayudu ",2013,2019,55,53,17,17,17,0,0,2
"525","CJ Richards ",1981,1988,22,22,17,16,0,16,1,3
"526","TT Samaraweera ",1998,2011,53,51,17,17,17,0,0,2
"527","MS Sinclair ",2000,2009,54,54,17,17,15,2,0,2
"528","Umar Gul ",2003,2016,130,128,17,17,17,0,0,2
"529","GM Wood ",1978,1989,83,80,17,17,17,0,0,2
"530","Aamer Malik ",1988,1994,24,24,16,13,3,10,3,2
"531","CWJ Athey ",1980,1988,31,31,16,16,16,0,0,3
"532","JJ Atkinson ",2008,2017,9,9,16,10,0,10,6,4
"533","WKM Benjamin ",1986,1995,85,85,16,16,16,0,0,1
"534","N Chopra ",1998,2000,39,38,16,16,16,0,0,2
"535","KJ Coetzer ",2008,2019,59,58,16,16,16,0,0,2
"536","PJ Cummins ",2011,2020,64,64,16,16,16,0,0,2
"537","Dawlat Zadran ",2011,2019,82,80,16,16,16,0,0,2
"538","RL Dias ",1979,1987,58,58,16,16,16,0,0,2
"539","BN French ",1985,1988,13,13,16,13,0,13,3,3
"540","BJ Hodge ",2005,2007,25,25,16,16,16,0,0,2
"541","GP Howarth ",1975,1985,70,69,16,16,16,0,0,2
"542","APE Knott ",1971,1977,20,19,16,15,0,15,1,4
"543","T Mishra ",2006,2013,42,42,16,16,16,0,0,2
"544","DA Murray ",1973,1981,10,10,16,16,0,16,0,3
"545","TJ Murtagh ",2012,2019,58,57,16,16,16,0,0,1
"546","Naved-ul-Hasan ",2003,2010,74,72,16,16,16,0,0,2
"547","A Ratra ",2002,2002,12,12,16,11,0,11,5,3
"548","GJ Rennie ",1996,2003,40,40,16,16,16,0,0,2
"549","RD Shah ",1998,2007,56,56,16,16,16,0,0,2
"550","VS Solanki ",2000,2006,51,50,16,16,16,0,0,2
"551","A Vala ",2014,2019,27,27,16,16,16,0,0,3
"552","Zaheer Abbas ",1974,1985,62,60,16,16,16,0,0,2
"553","Anil Dalpat ",1984,1986,15,14,15,13,0,13,2,3
"554","MA Atherton ",1990,1998,54,54,15,15,15,0,0,2
"555","Basit Ali ",1993,1996,50,49,15,15,15,0,0,2
"556","SE Bond ",2002,2010,82,80,15,15,15,0,0,2
"557","YS Chahal ",2016,2020,52,52,15,15,15,0,0,2
"558","SKL de Silva ",1997,1997,11,11,15,9,0,9,6,3
"559","PS de Villiers ",1992,1997,83,82,15,15,15,0,0,2
"560","ST Finn ",2011,2017,69,67,15,15,15,0,0,2
"561","DT Hondo ",2001,2005,56,56,15,15,15,0,0,1
"562","VG Kambli ",1991,2000,104,101,15,15,15,0,0,1
"563","MD Marshall ",1980,1992,136,134,15,15,15,0,0,2
"564","BAW Mendis ",2008,2015,87,85,15,15,15,0,0,2
"565","JA Morkel ",2004,2012,58,58,15,15,15,0,0,2
"566","Noor Ali Zadran ",2009,2019,51,49,15,15,15,0,0,2
"567","AR Nurse ",2016,2019,54,52,15,15,15,0,0,3
"568","AA Obanda ",2007,2014,49,49,15,15,15,0,0,2
"569","JL Ontong ",2001,2012,28,27,15,15,15,0,0,2
"570","AR Patel ",2014,2017,38,36,15,15,15,0,0,2
"571","KL Rahul ",2016,2020,32,32,15,13,8,5,2,3
"572","Rizwan Cheema ",2008,2013,33,32,15,15,15,0,0,2
"573","Rohan Mustafa ",2014,2020,37,37,15,15,15,0,0,2
"574","JD Ryder ",2008,2014,48,48,15,15,15,0,0,2
"575","Sohail Tanvir ",2007,2014,62,60,15,15,15,0,0,2
"576","CM Spearman ",1995,2001,51,51,15,15,15,0,0,1
"577","BC Strang ",1995,2001,49,48,15,15,15,0,0,2
"578","HA Varaiya ",2006,2014,63,63,15,15,15,0,0,2
"579","KJ Wadsworth ",1973,1976,13,13,15,13,0,13,2,3
"580","CD Wallace ",2012,2019,28,28,15,13,8,5,2,4
"581","Asad Shafiq ",2010,2017,60,59,14,14,14,0,0,2
"582","EAE Baptiste ",1983,1990,43,43,14,14,14,0,0,2
"583","AC Cummins ",1991,2007,76,75,14,14,14,0,0,2
"584","A Dananjaya ",2012,2019,36,35,14,14,14,0,0,2
"585","C de Grandhomme ",2012,2020,42,42,14,14,14,0,0,2
"586","DW Fleming ",1994,2001,88,88,14,14,14,0,0,1
"587","HA Gomes ",1978,1987,83,83,14,14,14,0,0,1
"588","PSP Handscomb ",2017,2019,22,22,14,14,9,5,0,3
"589","HMRKB Herath ",2004,2015,71,69,14,14,14,0,0,2
"590","Imran Farhat ",2001,2013,58,58,14,14,14,0,0,1
"591","HH Kanitkar ",1997,2000,34,34,14,14,14,0,0,2
"592","Mansoor Akhtar ",1980,1990,41,40,14,14,14,0,0,2
"593","LRD Mendis ",1975,1989,79,79,14,14,14,0,0,2
"594","AA Mulla ",2006,2009,24,24,14,9,5,4,5,2
"595","SP Narine ",2011,2016,65,65,14,14,14,0,0,2
"596","KOA Powell ",2009,2018,46,45,14,14,14,0,0,2
"597","R Powell ",2016,2018,34,33,14,14,14,0,0,2
"598","R Rampaul ",2003,2015,92,89,14,14,14,0,0,2
"599","JR Ratnayeke ",1982,1990,78,78,14,14,14,0,0,2
"600","Shafiqullah ",2009,2018,24,24,14,11,3,8,3,2
"601","JC Tredwell ",2010,2015,45,44,14,14,14,0,0,2
"602","IJL Trott ",2009,2013,68,66,14,14,14,0,0,2
"603","LJ Tucker ",2019,2020,8,8,14,13,1,12,1,3
"604","RR Watson ",2006,2010,35,34,14,14,14,0,0,2
"605","Yasir Hameed ",2003,2007,56,56,14,14,14,0,0,2
"606","Aminul Islam ",1988,2002,39,39,13,13,13,0,0,2
"607","HK Badani ",2000,2004,40,40,13,13,13,0,0,2
"608","B Bhandari ",2019,2020,7,7,13,12,0,12,1,4
"609","SW Billings ",2015,2018,15,15,13,13,9,4,0,2
"610","PB Dassanayake ",1993,1994,16,16,13,9,0,9,4,2
"611","ALF de Mel ",1982,1987,57,57,13,13,13,0,0,2
"612","Dhiman Ghosh ",2008,2008,14,14,13,9,0,9,4,4
"613","Farhad Reza ",2006,2011,34,34,13,13,13,0,0,2
"614","DA Gunawardene ",1998,2006,61,61,13,13,13,0,0,2
"615","JR Hazlewood ",2010,2020,48,48,13,13,13,0,0,2
"616","RR Hendricks ",2018,2020,21,20,13,13,13,0,0,3
"617","AJ Hollioake ",1996,1999,35,35,13,13,13,0,0,3
"618","MS Kasprowicz ",1995,2005,43,42,13,13,13,0,0,2
"619","SM Katich ",2001,2006,45,45,13,13,13,0,0,1
"620","UT Khawaja ",2013,2019,40,40,13,13,13,0,0,2
"621","NFI McCallum ",2006,2011,43,42,13,13,13,0,0,2
"622","R McLaren ",2009,2014,54,52,13,13,13,0,0,1
"623","Mehidy Hasan Miraz ",2017,2020,41,40,13,13,13,0,0,3
"624","BMAJ Mendis ",2010,2019,58,56,13,13,13,0,0,2
"625","Mohsin Khan ",1977,1986,75,73,13,13,13,0,0,2
"626","Mosaddek Hossain ",2016,2019,35,34,13,13,13,0,0,2
"627","Nasir Jamshed ",2008,2015,48,48,13,13,13,0,0,2
"628","HK Olonga ",1995,2003,50,50,13,13,13,0,0,2
"629","JS Patel ",2005,2017,43,42,13,13,13,0,0,1
"630","AL Phehlukwayo ",2016,2020,58,56,13,13,13,0,0,2
"631","DBL Powell ",2002,2009,55,55,13,13,13,0,0,2
"632","Shahriar Nafees ",2005,2011,75,75,13,13,13,0,0,2
"633","Shoaib Mohammad ",1984,1993,63,62,13,13,13,0,0,2
"634","RP Singh ",2005,2011,58,58,13,13,13,0,0,1
"635","DS Smith ",2003,2013,47,46,13,13,13,0,0,3
"636","RN ten Doeschate ",2006,2011,33,33,13,13,13,0,0,2
"637","GM Turner ",1973,1983,41,41,13,13,13,0,0,2
"638","DNT Zoysa ",1997,2007,95,94,13,13,13,0,0,2
"639","Akshay Homraj ",2019,2020,8,8,12,12,0,12,0,4
"640","Amjad Ali ",2008,2015,17,17,12,11,7,4,1,3
"641","PK Amre ",1991,1994,37,36,12,12,12,0,0,2
"642","RMH Binny ",1980,1987,72,70,12,12,12,0,0,2
"643","IR Bishop ",1988,1997,84,83,12,12,12,0,0,1
"644","DE Bollinger ",2009,2011,39,39,12,12,12,0,0,1
"645","JM Brearley ",1977,1980,25,25,12,12,12,0,0,2
"646","C Carter ",2015,2018,11,11,12,10,1,9,2,3
"647","CD Collymore ",1999,2007,84,83,12,12,12,0,0,2
"648","TLW Cooper ",2010,2013,23,23,12,12,12,0,0,2
"649","KM Dabengwa ",2005,2010,37,37,12,12,12,0,0,2
"650","JWM Dalrymple ",2006,2007,27,27,12,12,12,0,0,2
"651","KSC de Silva ",1996,2000,38,37,12,12,12,0,0,2
"652","J Dyson ",1980,1983,29,29,12,12,12,0,0,3
"653","BA Edgar ",1978,1986,64,63,12,12,12,0,0,2
"654","CN Evans ",1992,2002,53,52,12,12,12,0,0,2
"655","NA Foster ",1984,1989,48,48,12,12,12,0,0,2
"656","Gulbadin Naib ",2011,2019,65,63,12,12,12,0,0,1
"657","MD Gunathilaka ",2015,2019,38,37,12,12,12,0,0,2
"658","Hasan Ali ",2016,2019,53,52,12,12,12,0,0,2
"659","TM Head ",2016,2018,42,42,12,12,12,0,0,2
"660","MJ Horne ",1997,2002,50,49,12,12,12,0,0,2
"661","Imad Wasim ",2015,2019,53,52,12,12,12,0,0,1
"662","CA Ingram ",2010,2013,31,31,12,12,12,0,0,2
"663","Javed Omar ",1995,2007,59,59,12,12,12,0,0,2
"664","SG Law ",1994,1999,54,54,12,12,12,0,0,2
"665","DA Marillier ",2000,2003,48,48,12,12,12,0,0,2
"666","AK Markram ",2017,2019,26,25,12,12,12,0,0,3
"667","XM Marshall ",2005,2020,37,36,12,12,12,0,0,2
"668","T Maruma ",2007,2019,21,21,12,12,12,0,0,3
"669","SF Mire ",2014,2019,47,47,12,12,12,0,0,1
"670","HS Modi ",1996,2006,63,63,12,12,12,0,0,2
"671","J Mubarak ",2002,2013,40,40,12,12,12,0,0,2
"672","Mustafizur Rahman ",2015,2020,58,57,12,12,12,0,0,2
"673","Nadeem Ahmed ",2004,2018,25,25,12,12,12,0,0,2
"674","MO Odumbe ",1996,2003,61,61,12,12,12,0,0,2
"675","JM Parker ",1974,1981,24,24,12,11,11,0,1,3
"676","WD Parnell ",2009,2017,65,62,12,12,12,0,0,2
"677","DA Reeve ",1991,1996,29,29,12,12,12,0,0,3
"678","JA Rennie ",1993,2000,44,44,12,12,12,0,0,2
"679","PM Seelaar ",2006,2019,41,41,12,12,12,0,0,2
"680","Shaiman Anwar ",2014,2019,40,40,12,12,12,0,0,2
"681","MP Stoinis ",2015,2019,41,41,12,12,12,0,0,1
"682","C White ",1994,2003,51,50,12,12,12,0,0,1
"683","CJ Anderson ",2013,2017,49,48,11,11,11,0,0,2
"684","Babar Hayat ",2014,2018,22,22,11,11,11,0,0,2
"685","L Balaji ",2002,2009,30,30,11,11,11,0,0,2
"686","AM Blignaut ",1999,2010,54,54,11,11,11,0,0,2
"687","AC Botha ",2006,2011,42,40,11,11,11,0,0,2
"688","EA Brandes ",1987,1999,59,59,11,11,11,0,0,1
"689","CR Brathwaite ",2011,2019,44,42,11,11,11,0,0,1
"690","RL Chase ",2017,2020,30,28,11,11,11,0,0,2
"691","R Clarke ",2003,2006,20,20,11,11,11,0,0,3
"692","RDB Croft ",1996,2001,50,49,11,11,11,0,0,1
"693","AC Dale ",1997,2000,30,30,11,11,11,0,0,1
"694","J Edness ",2007,2008,11,11,11,7,0,7,4,3
"695","D Ganga ",1999,2006,35,35,11,11,11,0,0,2
"696","DW Hookes ",1977,1986,39,37,11,11,11,0,0,2
"697","KM Jarvis ",2009,2019,49,49,11,11,11,0,0,2
"698","Javed Ahmadi ",2010,2019,44,41,11,11,11,0,0,1
"699","PN Kirsten ",1991,1994,40,40,11,11,11,0,0,2
"700","P Kumar ",2007,2012,68,67,11,11,11,0,0,2
"701","CK Langeveldt ",2001,2010,72,71,11,11,11,0,0,1
"702","RT Latham ",1990,1994,33,33,11,11,11,0,0,2
"703","Mohammad Irfan ",2010,2016,60,60,11,11,11,0,0,2
"704","CB Mpofu ",2004,2020,84,83,11,11,11,0,0,1
"705","HG Munsey ",2017,2019,25,25,11,11,11,0,0,2
"706","BA Murphy ",2000,2003,31,31,11,11,11,0,0,2
"707","D Murphy ",2013,2013,8,8,11,8,0,8,3,5
"708","TK Musakanda ",2016,2018,15,15,11,11,11,0,0,2
"709","P Mustard ",2007,2008,10,10,11,9,0,9,2,2
"710","F Mutizwa ",2009,2011,17,17,11,9,1,8,2,3
"711","RJ Nicol ",2011,2013,22,22,11,11,11,0,0,2
"712","SB O'Connor ",1997,2000,38,38,11,11,11,0,0,2
"713","H Osinde ",2006,2013,42,41,11,11,11,0,0,2
"714","MM Patel ",2006,2011,70,68,11,11,11,0,0,2
"715","SM Patil ",1980,1986,45,44,11,11,11,0,0,2
"716","SP Patil ",2014,2015,13,13,11,8,0,8,3,3
"717","DR Pringle ",1982,1993,44,44,11,11,11,0,0,2
"718","CPH Ramanayake ",1986,1995,62,62,11,11,11,0,0,2
"719","RJ Ratnayake ",1982,1993,70,70,11,11,11,0,0,2
"720","SJ Rhodes ",1989,1995,9,9,11,9,0,9,2,4
"721","SJ Rixon ",1978,1985,6,6,11,9,0,9,2,4
"722","JA Rudolph ",2003,2006,45,45,11,11,11,0,0,2
"723","AD Russell ",2011,2019,56,56,11,11,11,0,0,1
"724","Sanwar Hossain ",1998,2003,27,27,11,11,11,0,0,2
"725","SM Sharif ",2011,2019,44,44,11,11,11,0,0,2
"726","MA Suji ",1996,2006,64,64,11,11,11,0,0,2
"727","Tahir Naqqash ",1980,1985,40,38,11,11,11,0,0,2
"728","TP Ura ",2014,2019,26,26,11,11,11,0,0,2
"729","DLS van Bunge ",2002,2013,37,37,11,11,11,0,0,2
"730","MN van Wyk ",2003,2015,17,17,11,10,1,9,1,4
"731","PA Wallace ",1991,2000,33,32,11,11,11,0,0,2
"732","MR Whitney ",1983,1993,38,38,11,11,11,0,0,3
"733","MA Wood ",2015,2019,51,50,11,11,11,0,0,2
"734","A Zampa ",2016,2020,55,55,11,11,11,0,0,1
"735","Amir Hamza ",2012,2017,31,31,10,10,10,0,0,2
"736","Anamul Haque ",2012,2019,38,38,10,10,4,6,0,3
"737","SD Anurasiri ",1986,1994,45,45,10,10,10,0,0,2
"738","Arshad Khan ",1993,2006,58,57,10,10,10,0,0,2
"739","SFAF Bacchus ",1978,1983,29,29,10,10,10,0,0,2
"740","BC Broad ",1987,1988,34,34,10,10,10,0,0,1
"741","RK Chauhan ",1993,1997,35,34,10,10,10,0,0,1
"742","DT Christian ",2012,2014,19,19,10,10,10,0,0,2
"743","SR Clark ",2005,2009,39,39,10,10,10,0,0,2
"744","JH Davey ",2010,2019,31,30,10,10,10,0,0,2
"745","SB Doull ",1992,2000,42,42,10,10,10,0,0,2
"746","Fawad Alam ",2007,2015,38,38,10,10,10,0,0,2
"747","LH Ferguson ",2016,2020,37,37,10,10,10,0,0,1
"748","JN Gillespie ",1996,2005,97,97,10,10,10,0,0,1
"749","DAS Gunaratne ",2016,2019,31,30,10,10,10,0,0,2
"750","RM Haq ",2006,2015,54,52,10,10,10,0,0,2
"751","SJ Harmison ",2002,2009,58,58,10,10,10,0,0,1
"752","BW Hilfenhaus ",2007,2012,25,25,10,10,10,0,0,2
"753","TG Hogan ",1983,1984,16,15,10,10,10,0,0,2
"754","Iftikhar Anjum ",2004,2010,62,61,10,10,10,0,0,3
"755","Ihsanullah ",2017,2018,16,16,10,10,10,0,0,3
"756","LM Jongwe ",2014,2016,22,22,10,10,10,0,0,3
"757","M Kartik ",2002,2007,37,37,10,10,10,0,0,1
"758","FDM Karunaratne ",2011,2020,31,31,10,10,10,0,0,1
"759","R Lamba ",1986,1989,32,32,10,10,10,0,0,1
"760","RDM Leverock ",2006,2009,32,32,10,10,10,0,0,2
"761","DK Lillee ",1972,1983,63,63,10,10,10,0,0,2
"762","DR Lockhart ",2006,2010,14,14,10,10,1,9,0,3
"763","CR Matthews ",1991,1997,56,55,10,10,10,0,0,2
"764","BJ McCarthy ",2016,2020,30,30,10,10,10,0,0,2
"765","Mohammad Salman ",2011,2011,7,7,10,8,0,8,2,4
"766","DS Mohanty ",1997,2001,45,44,10,10,10,0,0,2
"767","Muhammad Usman ",2016,2020,33,33,10,10,10,0,0,3
"768","KMA Paul ",2018,2020,19,19,10,10,10,0,0,2
"769","Saleem Elahi ",1995,2004,48,47,10,10,10,0,0,2
"770","Shabbir Ahmed ",1999,2005,32,32,10,10,10,0,0,2
"771","Simi Singh ",2017,2020,18,18,10,10,10,0,0,2
"772","Tauseef Ahmed ",1982,1990,70,68,10,10,10,0,0,1
"773","KL Tucker ",2006,2007,12,12,10,9,1,8,1,4
"774","AC Waller ",1987,1997,39,38,10,10,10,0,0,2
"775","KD Walters ",1971,1981,28,28,10,10,10,0,0,3
"776","CAK Walton ",2009,2017,9,9,10,9,3,6,1,4
"777","MH Yardy ",2006,2011,28,28,10,10,10,0,0,2
"778","Yashpal Sharma ",1978,1985,42,42,10,10,10,0,0,1
"779","CJA Amini ",2014,2019,15,15,9,9,9,0,0,1
"780","HS Baidwan ",2008,2014,32,32,9,9,9,0,0,1
"781","HMCM Bandara ",2006,2010,31,30,9,9,9,0,0,3
"782","SJ Benn ",2008,2016,47,46,9,9,9,0,0,1
"783","NT Broom ",2009,2017,39,39,9,9,9,0,0,2
"784","AR Caddick ",1993,2003,54,53,9,9,9,0,0,2
"785","LOB Cann ",2006,2009,26,26,9,9,9,0,0,2
"786","PP Chawla ",2007,2011,25,25,9,9,9,0,0,3
"787","N Deonarine ",2005,2015,31,31,9,9,9,0,0,2
"788","SI de Saram ",1999,2001,15,15,9,9,9,0,0,2
"789","MA Ealham ",1996,2001,64,63,9,9,9,0,0,1
"790","S Elworthy ",1998,2002,39,38,9,9,9,0,0,3
"791","ZE Green ",2019,2020,8,8,9,7,0,7,2,5
"792","Hashmatullah Shahidi ",2013,2019,39,38,9,9,9,0,0,1
"793","AS Joseph ",2016,2020,28,27,9,9,9,0,0,2
"794","IA Karim ",2011,2014,9,9,9,8,3,5,1,2
"795","CM Kuggeleijn ",1988,1989,16,16,9,9,9,0,0,2
"796","NC McGarrell ",1998,2001,17,17,9,9,9,0,0,2
"797","RD McCann ",2010,2010,8,8,9,9,0,9,0,3
"798","SS McKechnie ",2017,2018,8,8,9,8,1,7,1,4
"799","Mohammad Wasim ",1996,2000,25,25,9,9,9,0,0,2
"800","CH Morris ",2013,2019,42,40,9,9,9,0,0,1
"801","T Mupariwa ",2004,2016,40,40,9,9,9,0,0,1
"802","Nizakat Khan ",2014,2018,20,20,9,9,9,0,0,2
"803","SJ Palframan ",1996,1996,7,7,9,9,0,9,0,3
"804","RR Pant ",2018,2020,16,16,9,8,4,4,1,2
"805","T Panyangara ",2004,2016,65,65,9,9,9,0,0,2
"806","BP Patterson ",1986,1993,59,58,9,9,9,0,0,1
"807","N Pooran ",2019,2020,25,24,9,8,7,1,1,2
"808","AD Poynter ",2008,2014,19,18,9,9,9,0,0,2
"809","Rajin Saleh ",2003,2006,43,43,9,9,9,0,0,2
"810","GM Ritchie ",1982,1987,44,44,9,9,9,0,0,2
"811","AM Samad ",2003,2009,27,26,9,9,9,0,0,2
"812","MJ Slater ",1993,1997,42,42,9,9,9,0,0,2
"813","RS Sodhi ",2000,2002,18,18,9,9,9,0,0,2
"814","Sohaib Maqsood ",2013,2016,26,26,9,9,9,0,0,2
"815","Sohrawordi Shuvo ",2010,2011,17,17,9,9,9,0,0,2
"816","Suraj Kumar ",2019,2020,11,11,9,9,0,9,0,2
"817","Taufeeq Umar ",2001,2011,22,22,9,9,9,0,0,1
"818","JR Thomson ",1975,1985,50,50,9,9,9,0,0,2
"819","LL Tsotsobe ",2009,2013,61,60,9,9,9,0,0,2
"820","JJ Tucker ",2006,2009,26,26,9,9,9,0,0,2
"821","HE van der Dussen ",2019,2020,21,19,9,9,9,0,0,2
"822","JNT Vare ",2014,2018,9,9,9,6,0,6,3,3
"823","M Vijay ",2010,2015,17,17,9,9,9,0,0,2
"824","W Watson ",1986,1994,61,61,9,9,9,0,0,1
"825","AR Adams ",2001,2007,42,41,8,8,8,0,0,2
"826","Akram Khan ",1988,2003,44,44,8,8,8,0,0,2
"827","Amjad Javed ",2008,2017,15,15,8,8,8,0,0,1
"828","Azhar Ali ",2011,2018,53,52,8,8,8,0,0,1
"829","GS Ballance ",2013,2015,16,16,8,8,8,0,0,2
"830","D Bau ",2016,2017,10,10,8,6,1,5,2,3
"831","S Bau ",2016,2019,21,21,8,8,8,0,0,1
"832","ID Blackwell ",2002,2006,34,34,8,8,8,0,0,2
"833","JAR Blain ",1999,2009,33,32,8,8,8,0,0,1
"834","MG Burgess ",1973,1981,26,26,8,8,8,0,0,2
"835","RP Burl ",2017,2019,18,18,8,8,8,0,0,2
"836","IG Butler ",2002,2010,26,25,8,8,8,0,0,2
"837","TM Chappell ",1980,1983,20,20,8,8,8,0,0,2
"838","FRJ Coleman ",2013,2015,16,15,8,8,8,0,0,3
"839","PT Collins ",1999,2005,30,30,8,8,8,0,0,2
"840","MD Dai ",2014,2018,18,18,8,8,8,0,0,2
"841","SM Davies ",2009,2011,8,8,8,8,0,8,0,2
"842","S Dhaniram ",2006,2010,44,43,8,8,8,0,0,1
"843","Enamul Haque jnr ",2005,2009,10,10,8,8,8,0,0,2
"844","AC Evans ",2009,2019,36,35,8,8,8,0,0,1
"845","ADS Fletcher ",2008,2016,25,25,8,5,3,2,3,3
"846","Hannan Sarkar ",2002,2004,20,20,8,8,6,2,0,2
"847","RM Hogg ",1979,1985,71,69,8,8,8,0,0,1
"848","RIC Holder ",1993,1997,37,37,8,8,8,0,0,3
"849","RK Illingworth ",1991,1996,25,25,8,8,8,0,0,2
"850","SS Iyer ",2017,2020,18,18,8,8,8,0,0,2
"851","BP Julian ",1993,1999,25,25,8,8,8,0,0,2
"852","Junaid Khan ",2011,2019,76,76,8,8,8,0,0,1
"853","AI Kallicharran ",1973,1981,31,31,8,8,8,0,0,2
"854","SC Khanna ",1979,1984,10,9,8,4,0,4,4,3
"855","GF Labrooy ",1986,1992,44,44,8,8,8,0,0,1
"856","W Larkins ",1979,1991,25,25,8,8,8,0,0,1
"857","NAM McLean ",1996,2003,45,45,8,8,8,0,0,2
"858","Manjural Islam ",1999,2003,34,34,8,8,8,0,0,1
"859","VJ Marks ",1980,1988,34,34,8,8,8,0,0,1
"860","Mirwais Ashraf ",2009,2016,46,45,8,8,8,0,0,2
"861","Mohammad Akram ",1995,2000,23,21,8,8,8,0,0,2
"862","Mohammad Amir ",2009,2019,61,60,8,8,8,0,0,2
"863","S Mukuddem ",2006,2007,20,20,8,8,8,0,0,1
"864","AD Mullally ",1996,2001,50,49,8,8,8,0,0,2
"865","L Ngidi ",2018,2020,26,26,8,8,8,0,0,2
"866","CM Old ",1973,1981,32,32,8,8,8,0,0,2
"867","DR Parry ",1978,1980,6,6,8,8,8,0,0,2
"868","KR Pushpakumara ",1994,1999,31,31,8,8,8,0,0,3
"869","EC Rainsford ",2004,2010,39,39,8,8,8,0,0,2
"870","SLV Raju ",1990,1996,53,52,8,8,8,0,0,1
"871","MR Ramprakash ",1991,2001,18,18,8,8,8,0,0,2
"872","MJR Rindel ",1994,1999,22,22,8,8,8,0,0,2
"873","IH Romaine ",2006,2009,35,35,8,8,8,0,0,2
"874","PADLR Sandakan ",2016,2020,24,24,8,8,8,0,0,2
"875","Sarfraz Nawaz ",1973,1984,45,45,8,8,8,0,0,1
"876","TL Seifert ",2019,2019,3,3,8,7,0,7,1,4
"877","Shadab Khan ",2017,2019,43,43,8,8,8,0,0,1
"878","Shafiul Islam ",2010,2020,60,60,8,8,8,0,0,2
"879","L Siaka ",2014,2019,25,25,8,8,8,0,0,2
"880","SB Smith ",1983,1985,28,27,8,8,8,0,0,1
"881","IS Sodhi ",2015,2020,33,32,8,8,8,0,0,2
"882","Syed Rasel ",2005,2010,52,52,8,8,8,0,0,2
"883","SW Tait ",2007,2011,35,35,8,8,8,0,0,2
"884","Tapash Baisya ",2002,2007,56,56,8,8,8,0,0,1
"885","SR Taylor ",2019,2020,12,12,8,8,8,0,0,2
"886","SR Thompson ",2013,2017,20,19,8,8,8,0,0,1
"887","N Vanua ",2014,2019,23,23,8,8,8,0,0,2
"888","MRJ Veletta ",1987,1989,20,20,8,8,7,1,0,3
"889","DM Wellham ",1981,1987,17,17,8,8,8,0,0,2
"890","LR Williams ",1996,2001,15,15,8,8,8,0,0,2
"891","KJ Wright ",1979,1979,5,5,8,8,0,8,0,2
"892","KJ Abbott ",2013,2016,28,27,7,7,7,0,0,2
"893","Abdur Rehman ",2006,2014,31,31,7,7,7,0,0,2
"894","PR Adams ",1996,2003,24,24,7,7,7,0,0,2
"895","Al Sahariar ",1999,2003,29,29,7,7,7,0,0,2
"896","Asif Iqbal ",1973,1979,10,10,7,7,7,0,0,2
"897","KBJ Azad ",1980,1986,25,24,7,7,7,0,0,2
"898","GEF Barnett ",2006,2010,22,22,7,7,7,0,0,1
"899","DE Bernard ",2003,2010,20,19,7,7,7,0,0,1
"900","IS Billcliff ",2003,2009,19,19,7,7,7,0,0,2
"901","D Bishoo ",2011,2019,42,41,7,7,7,0,0,1
"902","GS Blewett ",1995,1999,32,32,7,7,7,0,0,2
"903","JL Carter ",2015,2019,33,32,7,7,7,0,0,2
"904","NM Coulter-Nile ",2013,2019,32,32,7,7,7,0,0,1
"905","CD de Lange ",2016,2017,13,13,7,7,7,0,0,3
"906","TBM de Leede ",1996,2007,29,29,7,7,7,0,0,2
"907","JL Denly ",2009,2020,16,16,7,7,7,0,0,2
"908","AIC Dodemaide ",1988,1993,24,24,7,7,7,0,0,2
"909","MG Erasmus ",2019,2020,8,8,7,7,7,0,0,2
"910","CJ Ferguson ",2009,2011,30,29,7,7,7,0,0,2
"911","SR Gillespie ",1986,1988,19,19,7,7,7,0,0,2
"912","G Goudie ",2008,2013,16,16,7,7,7,0,0,2
"913","AW Greig ",1972,1977,22,21,7,7,7,0,0,3
"914","R Gunasekera ",2008,2014,19,19,7,7,7,0,0,2
"915","GM Hamilton ",1999,2010,38,38,7,6,6,0,1,1
"916","AS Hansra ",2010,2014,24,24,7,7,7,0,0,1
"917","MN Hart ",1994,2002,13,13,7,7,7,0,0,2
"918","DL Hemp ",2006,2009,22,22,7,7,7,0,0,3
"919","AG Huckle ",1997,1999,19,19,7,7,7,0,0,2
"920","Humayun Farhat ",2001,2001,5,5,7,4,0,4,3,3
"921","KAD Hurdle ",2006,2007,19,19,7,7,7,0,0,1
"922","Imam-ul-Haq ",2017,2019,37,36,7,7,7,0,0,1
"923","Jahurul Islam ",2010,2013,14,14,7,7,3,4,0,3
"924","NG Jones ",2010,2011,14,14,7,7,7,0,0,2
"925","S Randiv ",2009,2016,31,30,7,7,7,0,0,1
"926","SHT Kandamby ",2004,2014,39,38,7,7,7,0,0,2
"927","P Khadka ",2018,2020,10,10,7,7,7,0,0,3
"928","Khawar Ali ",2019,2020,11,11,7,7,7,0,0,2
"929","Kuldeep Yadav ",2017,2020,60,59,7,7,7,0,0,1
"930","NR Kumar ",2010,2014,16,16,7,7,7,0,0,2
"931","RN Lewis ",1997,2009,28,28,7,7,7,0,0,1
"932","NM Lyon ",2012,2019,29,29,7,7,7,0,0,2
"933","PD McGlashan ",2009,2009,4,4,7,7,0,7,0,3
"934","CJ McKay ",2009,2014,59,59,7,7,7,0,0,3
"935","CS Martin ",2001,2008,20,19,7,7,7,0,0,1
"936","SW Masakadza ",2010,2014,16,16,7,7,7,0,0,3
"937","Mehrab Hossain jnr ",2006,2009,18,18,7,7,7,0,0,1
"938","Mohammad Mithun ",2014,2020,27,27,7,7,7,0,0,2
"939","VV Morea ",2014,2018,13,13,7,7,7,0,0,2
"940","CT Mutombodzi ",2013,2020,14,14,7,7,7,0,0,3
"941","B Muzarabani ",2018,2018,18,18,7,7,7,0,0,2
"942","Naimur Rahman ",1995,2002,29,29,7,7,7,0,0,2
"943","J Nyumbu ",2014,2015,19,19,7,7,7,0,0,2
"944","NN Odhiambo ",2006,2014,69,69,7,7,7,0,0,1
"945","PP Ojha ",2008,2012,18,18,7,7,7,0,0,3
"946","E Otieno ",2007,2014,26,26,7,7,7,0,0,2
"947","MK Pandey ",2015,2020,26,26,7,7,7,0,0,1
"948","BJ Patel ",2001,2006,31,31,7,7,7,0,0,1
"949","H Patel ",2009,2013,23,22,7,7,7,0,0,2
"950","SR Patel ",2008,2013,36,36,7,7,7,0,0,2
"951","NS Poonia ",2006,2009,21,20,7,7,7,0,0,2
"952","S Prasanna ",2011,2019,40,40,7,7,7,0,0,1
"953","C Pringle ",1990,1995,64,64,7,7,7,0,0,1
"954","SMA Priyanjan ",2013,2015,23,23,7,7,7,0,0,1
"955","DJ Reekers ",2006,2009,19,19,7,7,7,0,0,2
"956","KW Richardson ",2013,2020,25,25,7,7,7,0,0,2
"957","BG Rogers ",2002,2005,15,15,7,7,7,0,0,1
"958","V Shankar ",2019,2019,12,12,7,7,7,0,0,1
"959","C Sharma ",1983,1994,65,64,7,7,7,0,0,1
"960","SK Sharma ",1988,1990,23,23,7,7,7,0,0,2
"961","M Sheikh ",1997,2000,21,21,7,7,7,0,0,1
"962","L Sivaramakrishnan ",1985,1987,16,16,7,7,7,0,0,3
"963","GC Small ",1987,1992,53,53,7,7,7,0,0,2
"964","RP Snell ",1991,1996,42,42,7,7,7,0,0,1
"965","Sohag Gazi ",2012,2014,20,20,7,7,7,0,0,2
"966","TB Sole ",2018,2019,10,10,7,7,7,0,0,2
"967","S Sreesanth ",2005,2011,53,52,7,7,7,0,0,1
"968","WF Stelling ",2006,2007,15,15,7,7,7,0,0,1
"969","ES Szwarczynski ",2006,2014,41,41,7,7,7,0,0,1
"970","Taskin Ahmed ",2014,2017,32,31,7,7,7,0,0,1
"971","CJ Tavare ",1980,1984,29,29,7,7,7,0,0,2
"972","JWA Taylor ",2011,2015,27,27,7,7,7,0,0,3
"973","AC Voges ",2007,2013,31,31,7,7,7,0,0,2
"974","DF Watts ",2006,2011,36,35,7,7,7,0,0,2
"975","VJ Wells ",1999,1999,9,9,7,7,7,0,0,3
"976","Aftab Alam ",2010,2019,27,27,6,6,6,0,0,2
"977","AC Agar ",2015,2020,13,13,6,6,6,0,0,1
"978","FA Allen ",2018,2020,14,13,6,6,6,0,0,2
"979","Ashfaq Ahmed ",2018,2019,16,16,6,6,6,0,0,2
"980","IDR Bradshaw ",2004,2007,62,62,6,6,6,0,0,1
"981","JP Bray ",2006,2007,15,15,6,6,5,1,0,2
"982","AD Brown ",1996,2001,16,16,6,6,6,0,0,2
"983","DG Brownlie ",2012,2017,16,16,6,6,6,0,0,1
"984","Mudassar Bukhari ",2007,2014,46,46,6,6,6,0,0,1
"985","LJ Burger ",2003,2003,6,6,6,6,6,0,0,3
"986","DJ Callaghan ",1992,2000,29,28,6,6,6,0,0,2
"987","DJ Capel ",1987,1990,23,23,6,6,6,0,0,2
"988","TL Chatara ",2013,2019,70,70,6,6,6,0,0,1
"989","S Chattergoon ",2006,2009,18,17,6,6,6,0,0,2
"990","TS Chisoro ",2015,2018,18,17,6,6,6,0,0,2
"991","GR Codrington ",2006,2007,17,17,6,6,6,0,0,1
"992","DG Cork ",1992,2002,32,32,6,6,6,0,0,2
"993","CD Cumming ",2003,2009,13,13,6,6,6,0,0,2
"994","WM Darling ",1978,1982,18,17,6,6,6,0,0,3
"995","TN de Grooth ",2006,2013,34,34,6,6,6,0,0,1
"996","AM de Silva ",1986,1993,4,4,6,4,0,4,2,3
"997","EAR de Silva ",1986,1992,28,28,6,6,6,0,0,2
"998","T Duffin ",2006,2007,23,23,6,6,6,0,0,1
"999","PH Edmonds ",1977,1987,29,29,6,6,6,0,0,2
"1000","Enamul Haque ",1990,2002,29,29,6,6,6,0,0,3
"1001","N Pradeep ",2012,2020,45,44,6,6,6,0,0,2
"1002","WIA Fernando ",2016,2020,18,18,6,6,6,0,0,2
"1003","G Fowler ",1983,1986,26,26,6,4,2,2,2,3
"1004","AD Gaekwad ",1975,1987,15,14,6,6,6,0,0,1
"1005","MR Gillespie ",2006,2009,32,31,6,6,6,0,0,2
"1006","Hamza Tariq ",2011,2014,7,7,6,5,0,5,1,2
"1007","RJ Harris ",2009,2012,21,21,6,6,6,0,0,1
"1008","Harvinder Singh ",1997,2001,16,16,6,6,6,0,0,1
"1009","Hasibul Hossain ",1995,2004,32,32,6,6,6,0,0,2
"1010","UC Hathurusingha ",1992,1999,35,35,6,6,6,0,0,1
"1011","VA Holder ",1973,1978,12,12,6,6,6,0,0,1
"1012","BC Hollioake ",1997,2002,20,20,6,6,6,0,0,1
"1013","MG Hughes ",1988,1993,33,33,6,6,6,0,0,1
"1014","Ikram Alikhil ",2019,2019,12,11,6,3,0,3,3,2
"1015","Imtiaz Abbasi ",1994,1996,7,7,6,4,0,4,2,2
"1016","RC Irani ",1996,2003,31,31,6,6,6,0,0,1
"1017","WR James ",1992,1996,11,11,6,6,3,3,0,2
"1018","TP Kamungozi ",2006,2015,14,14,6,6,6,0,0,2
"1019","AY Karim ",1996,2003,34,34,6,6,6,0,0,1
"1020","Karim Sadiq ",2009,2016,24,24,6,6,6,0,0,2
"1021","Khurram Khan ",2004,2015,16,16,6,6,6,0,0,2
"1022","CL King ",1976,1980,18,18,6,6,6,0,0,1
"1023","JK Lever ",1976,1982,22,22,6,6,6,0,0,2
"1024","DK Liyanage ",1992,2001,16,16,6,6,6,0,0,2
"1025","NB Mahwire ",2004,2006,23,23,6,6,6,0,0,2
"1026","Manjural Islam Rana ",2003,2006,25,25,6,6,6,0,0,1
"1027","JJ Martin ",1999,2001,10,10,6,6,6,0,0,3
"1028","Mehrab Hossain ",1998,2003,18,18,6,6,6,0,0,2
"1029","Mohammad Naveed ",2014,2019,39,39,6,6,6,0,0,1
"1030","JFM Morrison ",1975,1983,18,18,6,6,6,0,0,2
"1031","Mujeeb Ur Rahman ",2017,2019,40,39,6,6,6,0,0,1
"1032","Mushfiqur Rahman ",2000,2004,28,28,6,6,6,0,0,1
"1033","MV Nagamootoo ",2000,2002,24,24,6,6,6,0,0,1
"1034","A Nao ",2017,2019,13,13,6,6,6,0,0,2
"1035","Nazmul Hossain ",2004,2012,38,38,6,6,6,0,0,1
"1036","SN Netravalkar ",2019,2020,13,13,6,6,6,0,0,3
"1037","JO Ngoche ",2010,2013,17,17,6,6,6,0,0,1
"1038","ML Nkala ",1998,2006,50,50,6,6,6,0,0,1
"1039","AH Omarshah ",1983,1996,28,28,6,6,6,0,0,2
"1040","SD Outerbridge ",2006,2009,23,23,6,6,6,0,0,1
"1041","LS Pascoe ",1977,1982,29,29,6,6,6,0,0,1
"1042","TRO Payne ",1984,1987,7,7,6,6,4,2,0,2
"1043","VD Philander ",2007,2015,30,28,6,6,6,0,0,2
"1044","N Pokana ",2017,2019,14,14,6,6,6,0,0,3
"1045","D Pretorius ",2016,2019,22,22,6,6,6,0,0,2
"1046","AJ Pycroft ",1983,1992,20,20,6,6,6,0,0,2
"1047","CG Rackemann ",1983,1991,52,52,6,6,6,0,0,1
"1048","Rameez Shahzad ",2016,2018,15,15,6,6,6,0,0,1
"1049","BA Reid ",1986,1992,61,61,6,6,6,0,0,2
"1050","AME Roberts ",1975,1983,56,56,6,6,6,0,0,1
"1051","RT Robinson ",1984,1988,26,26,6,6,6,0,0,2
"1052","FA Rose ",1997,2000,27,27,6,6,6,0,0,1
"1053","Sandeep Goud ",2019,2020,11,11,6,6,6,0,0,2
"1054","Shabir Noori ",2010,2016,10,10,6,6,6,0,0,2
"1055","Sharjeel Khan ",2013,2017,25,25,6,6,6,0,0,1
"1056","AK Sharma ",1988,1993,31,31,6,6,6,0,0,2
"1057","MM Sharma ",2013,2015,26,25,6,6,6,0,0,1
"1058","RJ Sidebottom ",2001,2010,25,25,6,6,6,0,0,1
"1059","EO Simons ",1994,1995,23,23,6,6,6,0,0,1
"1060","TAM Siriwardana ",2015,2019,27,26,6,6,6,0,0,2
"1061","ZE Surkari ",2008,2011,23,22,6,6,6,0,0,1
"1062","RML Taylor ",2013,2016,15,15,6,6,6,0,0,2
"1063","Tushar Imran ",2001,2007,41,41,6,6,6,0,0,1
"1064","Umar Amin ",2010,2018,16,16,6,6,6,0,0,2
"1065","DL Underwood ",1973,1982,26,26,6,6,6,0,0,2
"1066","AV Vadher ",1997,1999,18,18,6,6,6,0,0,2
"1067","LP van Troost ",2002,2007,23,23,6,6,6,0,0,1
"1068","Y Venugopal Rao ",2005,2006,16,16,6,6,6,0,0,2
"1069","R Vinay Kumar ",2010,2013,31,31,6,6,6,0,0,2
"1070","MHN Walker ",1974,1981,17,17,6,6,6,0,0,1
"1071","MRJ Watt ",2016,2019,27,27,6,6,6,0,0,1
"1072","AGD Wickremasinghe ",1992,1993,4,4,6,2,0,2,4,3
"1073","B Wood ",1972,1982,13,13,6,6,6,0,0,2
"1074","Yasir Shah ",2011,2019,25,25,6,6,6,0,0,2
"1075","Zeeshan Maqsood ",2019,2020,11,11,6,6,6,0,0,2
"1076","Abdul Shakoor ",2015,2018,3,3,5,4,2,2,1,3
"1077","GI Allott ",1997,2000,31,31,5,5,5,0,0,1
"1078","Anshuman Rath ",2014,2018,18,18,5,5,5,0,0,1
"1079","Arafat Sunny ",2014,2015,16,16,5,5,5,0,0,1
"1080","V Aravind ",2019,2020,6,6,5,4,0,4,1,3
"1081","Arshad Ayub ",1987,1990,32,32,5,5,5,0,0,1
"1082","Asif Ali ",2018,2019,18,17,5,5,5,0,0,1
"1083","JT Ball ",2016,2018,18,18,5,5,5,0,0,3
"1084","CA Best ",1986,1992,24,23,5,5,5,0,0,2
"1085","U Bhatti ",2006,2010,36,35,5,5,5,0,0,1
"1086","SL Boock ",1978,1987,14,13,5,5,5,0,0,1
"1087","G Boycott ",1971,1981,36,35,5,5,5,0,0,3
"1088","DH Brain ",1992,1995,23,23,5,5,5,0,0,2
"1089","RD Brown ",1983,1987,7,7,5,5,5,0,0,2
"1090","RJ Campbell ",2002,2002,2,2,5,4,0,4,1,3
"1091","IM Chappell ",1971,1980,16,16,5,5,5,0,0,2
"1092","PKD Chase ",2015,2018,25,24,5,5,5,0,0,2
"1093","NG Cowans ",1983,1985,23,23,5,5,5,0,0,1
"1094","CE Cuffy ",1994,2002,41,41,5,5,5,0,0,1
"1095","WW Daniel ",1978,1984,18,18,5,5,5,0,0,1
"1096","SP Davis ",1986,1988,39,39,5,5,5,0,0,1
"1097","MH Dekker ",1992,1996,23,23,5,5,5,0,0,1
"1098","JW Dernbach ",2011,2013,24,24,5,5,5,0,0,2
"1099","DS de Silva ",1975,1985,41,41,5,5,5,0,0,1
"1100","PWH de Silva ",2017,2020,15,15,5,5,5,0,0,2
"1101","K Doriga ",2017,2019,14,14,5,4,1,3,1,1
"1102","VC Drakes ",1995,2004,34,34,5,5,5,0,0,1
"1103","GD Drummond ",2007,2013,30,29,5,5,5,0,0,1
"1104","H Durham ",2006,2006,9,9,5,5,5,0,0,2
"1105","GN Edwards ",1976,1981,6,6,5,5,3,2,0,2
"1106","RMS Eranga ",2011,2016,19,18,5,5,5,0,0,2
"1107","SM Ervine ",2001,2004,42,42,5,5,5,0,0,1
"1108","Faheem Ashraf ",2017,2019,23,22,5,5,5,0,0,1
"1109","SE Findlay ",2008,2009,9,9,5,5,5,0,0,2
"1110","ARC Fraser ",1989,1999,42,42,5,5,5,0,0,1
"1111","RS Gavaskar ",2004,2004,11,11,5,5,5,0,0,2
"1112","AFG Griffith ",1996,2000,9,9,5,5,5,0,0,2
"1113","Hamid Hassan ",2009,2019,38,37,5,5,5,0,0,1
"1114","BR Hartland ",1992,1994,16,16,5,5,5,0,0,1
"1115","JW Hastings ",2010,2017,29,29,5,5,5,0,0,2
"1116","RC Haynes ",1989,1991,8,8,5,5,5,0,0,2
"1117","EE Hemmings ",1982,1991,33,33,5,5,5,0,0,1
"1118","M Hendrick ",1973,1981,22,22,5,5,5,0,0,1
"1119","RS Higgins ",2006,2006,11,11,5,5,5,0,0,1
"1120","PJC Hoffmann ",2006,2007,18,17,5,5,5,0,0,1
"1121","MJ Hoggard ",2001,2006,26,26,5,5,5,0,0,1
"1122","PJ Hughes ",2013,2014,25,25,5,5,3,2,0,2
"1123","RO Hurley ",2003,2004,9,9,5,5,5,0,0,2
"1124","Imran Haider ",2017,2019,20,20,5,5,5,0,0,1
"1125","Jatinder Singh ",2019,2020,11,11,5,5,5,0,0,1
"1126","WS Jayantha ",2004,2004,17,17,5,5,5,0,0,1
"1127","HAPW Jayawardene ",2003,2007,6,6,5,4,0,4,1,2
"1128","TE Jesty ",1983,1983,10,10,5,5,5,0,0,2
"1129","VB John ",1982,1987,45,45,5,5,5,0,0,1
"1130","MO Jones ",2006,2007,12,12,5,5,5,0,0,3
"1131","RJ Kirtley ",2001,2004,11,11,5,5,5,0,0,1
"1132","Krishna Chandran ",2014,2016,12,12,5,5,5,0,0,2
"1133","BP Kruger ",2010,2011,5,5,5,5,5,0,0,3
"1134","BM Laird ",1979,1982,23,23,5,5,5,0,0,1
"1135","D Langford-Smith ",2006,2008,22,21,5,5,5,0,0,2
"1136","KS Lokuarachchi ",2003,2007,21,21,5,5,5,0,0,1
"1137","GI Maiden ",2010,2011,7,7,5,5,0,5,0,3
"1138","JS Malhotra ",2019,2019,5,5,5,4,0,4,1,2
"1139","GA Manou ",2009,2009,4,4,5,5,0,5,0,3
"1140","A Mishra ",2003,2016,36,35,5,5,5,0,0,1
"1141","Mohammad Asif ",2005,2010,38,36,5,5,5,0,0,2
"1142","Mohammad Hussain ",1997,1998,14,13,5,5,5,0,0,2
"1143","Mohammad Nawaz ",2016,2019,15,15,5,5,5,0,0,2
"1144","Mohammad Tauqir ",2004,2015,11,11,5,5,5,0,0,2
"1145","MD Moxon ",1985,1988,8,8,5,5,5,0,0,2
"1146","AN Petersen ",2006,2013,21,21,5,5,5,0,0,1
"1147","N Pothas ",2000,2000,3,3,5,4,0,4,1,3
"1148","Qaiser Ali ",2006,2008,17,17,5,5,5,0,0,2
"1149","JF Reid ",1980,1986,25,23,5,5,5,0,0,1
"1150","DM Richards ",2009,2010,8,8,5,5,5,0,0,2
"1151","Sadiq Mohammad ",1973,1980,19,19,5,5,5,0,0,2
"1152","MAR Samarasekera ",1983,1994,39,39,5,5,5,0,0,2
"1153","BS Sandhu ",1982,1984,22,21,5,5,5,0,0,1
"1154","Shahadat Hossain ",2006,2013,51,51,5,5,5,0,0,1
"1155","Shahriar Hossain ",1997,2004,20,20,5,5,5,0,0,1
"1156","T Shamsi ",2016,2020,22,21,5,5,5,0,0,2
"1157","Shapoor Zadran ",2009,2019,44,44,5,5,5,0,0,1
"1158","Sharafuddin Ashraf ",2014,2019,17,17,5,5,5,0,0,3
"1159","JJ Smit ",2019,2020,8,8,5,5,5,0,0,2
"1160","JN Snape ",2001,2002,10,10,5,5,5,0,0,2
"1161","CA Soper ",2016,2019,20,20,5,5,5,0,0,2
"1162","ELR Stewart ",1993,2002,6,6,5,5,0,5,0,2
"1163","MR Swart ",2011,2014,12,12,5,5,5,0,0,2
"1164","J Theron ",2010,2020,13,13,5,5,5,0,0,2
"1165","I Udana ",2012,2020,18,18,5,5,5,0,0,2
"1166","Wajahatullah Wasti ",1999,2000,15,15,5,5,5,0,0,1
"1167","BGK Walker ",2000,2002,11,11,5,5,5,0,0,1
"1168","B Warnapura ",1975,1982,12,12,5,5,5,0,0,2
"1169","SR Waters ",2008,2011,20,20,5,5,5,0,0,2
"1170","CG Williams ",2019,2020,8,8,5,5,5,0,0,2
"1171","GH Worker ",2015,2018,10,10,5,5,5,0,0,3
"1172","GN Yallop ",1978,1984,30,27,5,5,5,0,0,2
"1173","Ziaur Rahman ",2013,2014,13,13,5,5,5,0,0,1
"1174","Adnan Mufti ",2017,2018,18,18,4,4,4,0,0,1
"1175","Ahsan Malik ",2011,2014,12,12,4,4,4,0,0,2
"1176","DS Airee ",2018,2020,10,10,4,4,4,0,0,1
"1177","Amir Hayat ",2018,2019,9,9,4,4,4,0,0,1
"1178","Anwar Ali ",2013,2016,22,22,4,4,4,0,0,2
"1179","Aqib Ilyas ",2019,2020,11,11,4,4,4,0,0,2
"1180","JC Archer ",2019,2019,14,14,4,4,4,0,0,1
"1181","J Arun Lal ",1982,1989,13,13,4,4,4,0,0,1
"1182","Atiq-uz-Zaman ",2000,2000,3,3,4,3,0,3,1,3
"1183","AM Bacher ",1997,2005,13,13,4,4,4,0,0,2
"1184","SB Bangar ",2002,2004,15,15,4,4,4,0,0,2
"1185","GD Barlow ",1976,1977,6,6,4,4,4,0,0,2
"1186","GJ Batty ",2002,2009,10,10,4,4,4,0,0,2
"1187","T Bavuma ",2016,2020,6,5,4,4,4,0,0,2
"1188","AC Bedade ",1994,1994,13,12,4,4,4,0,0,1
"1189","BS Bedi ",1974,1979,10,10,4,4,4,0,0,3
"1190","KCG Benjamin ",1992,1996,26,26,4,4,4,0,0,2
"1191","TL Best ",2004,2014,26,26,4,4,4,0,0,1
"1192","BR Blair ",1982,1986,14,13,4,4,4,0,0,2
"1193","DR Brown ",1997,2007,25,25,4,4,4,0,0,1
"1194","HR Bryan ",1999,1999,15,15,4,4,4,0,0,1
"1195","IP Butchart ",1983,1995,20,20,4,4,4,0,0,1
"1196","GD Campbell ",1989,1990,12,12,4,4,4,0,0,1
"1197","KED Carroll ",2007,2007,6,6,4,4,4,0,0,2
"1198","PVD Chameera ",2015,2019,23,23,4,4,4,0,0,1
"1199","BB Chari ",2015,2019,11,10,4,3,2,1,1,2
"1200","DN Chudasama ",1996,1999,20,20,4,4,4,0,0,1
"1201","ST Clarke ",1978,1982,10,10,4,4,4,0,0,1
"1202","GJ Cosier ",1975,1979,9,8,4,4,4,0,0,2
"1203","TK Curran ",2017,2020,20,20,4,4,4,0,0,1
"1204","PC de Silva ",2014,2017,7,7,4,4,4,0,0,2
"1205","GR Dilley ",1979,1988,36,36,4,4,4,0,0,2
"1206","FH Edwards ",2003,2009,50,49,4,4,4,0,0,1
"1207","SA Edwards ",2018,2019,4,4,4,4,0,4,0,3
"1208","D Elgar ",2012,2018,8,8,4,4,4,0,0,2
"1209","FM Engineer ",1974,1975,5,5,4,3,0,3,1,1
"1210","KWR Fletcher ",1971,1982,24,23,4,4,4,0,0,1
"1211","DR Flynn ",2008,2012,20,20,4,4,4,0,0,1
"1212","PJ Forrest ",2012,2012,15,15,4,4,4,0,0,1
"1213","RC Fredericks ",1973,1977,12,12,4,4,4,0,0,1
"1214","HJW Gardiner ",2013,2015,11,11,4,4,4,0,0,2
"1215","HM Goonatilleke ",1982,1982,6,6,4,0,0,0,4,2
"1216","TR Gripper ",2001,2003,8,8,4,4,4,0,0,2
"1217","Hammad Azam ",2011,2015,11,11,4,4,4,0,0,2
"1218","Haseeb Amjad ",2014,2016,7,7,4,4,4,0,0,1
"1219","BF Hastings ",1973,1975,11,11,4,4,4,0,0,2
"1220","M Hayward ",1998,2002,21,21,4,4,4,0,0,1
"1221","MC Henriques ",2009,2017,11,11,4,4,4,0,0,2
"1222","PA Hitchcock ",2002,2008,14,13,4,4,4,0,0,1
"1223","RD Jackman ",1974,1983,15,15,4,4,4,0,0,1
"1224","SC Joseph ",2000,2005,13,13,4,4,4,0,0,1
"1225","BD Julien ",1973,1977,12,12,4,4,4,0,0,1
"1226","S Jyoti ",2006,2010,14,13,4,4,4,0,0,1
"1227","Kaleemullah ",2019,2020,9,9,4,4,4,0,0,2
"1228","RB Kanhai ",1973,1975,7,7,4,4,4,0,0,1
"1229","MF Kent ",1981,1981,5,5,4,4,4,0,0,2
"1230","RD King ",1998,2005,50,50,4,4,4,0,0,1
"1231","RK Kleinveldt ",2013,2013,10,10,4,4,4,0,0,2
"1232","A Kuruvilla ",1997,1997,25,25,4,4,4,0,0,1
"1233","RP Lefebvre ",1996,2003,11,11,4,4,4,0,0,1
"1234","RT Lyons ",2006,2010,25,25,4,4,4,0,0,1
"1235","WK McCallan ",2006,2009,39,37,4,4,4,0,0,1
"1236","MJ McClenaghan ",2013,2016,48,46,4,4,4,0,0,1
"1237","A McGrath ",2003,2004,14,13,4,4,4,0,0,2
"1238","MW Machan ",2013,2016,23,22,4,4,4,0,0,1
"1239","AO Malhotra ",1982,1986,20,20,4,4,4,0,0,1
"1240","AA Mallett ",1971,1975,9,9,4,4,4,0,0,1
"1241","WP Masakadza ",2015,2018,17,17,4,4,4,0,0,2
"1242","AD Mascarenhas ",2007,2009,20,20,4,4,4,0,0,2
"1243","MJ Mason ",2003,2010,26,25,4,4,4,0,0,1
"1244","MP Maynard ",1994,2000,14,13,4,4,4,0,0,1
"1245","G Miller ",1977,1984,25,25,4,4,4,0,0,2
"1246","Mohsin Kamal ",1984,1989,19,19,4,4,4,0,0,1
"1247","Mominul Haque ",2012,2018,28,28,4,4,4,0,0,1
"1248","PWA Mulder ",2017,2019,10,10,4,4,4,0,0,2
"1249","Nasir Jamal ",2014,2018,16,15,4,4,4,0,0,2
"1250","EO Odumbe ",1996,1996,8,8,4,4,4,0,0,1
"1251","GAHM Parkar ",1982,1984,10,8,4,4,4,0,0,2
"1252","MD Patel ",2019,2020,13,13,4,4,3,1,0,1
"1253","SS Pathirana ",2015,2017,18,18,4,4,4,0,0,2
"1254","ASA Perera ",1998,2001,20,20,4,4,4,0,0,2
"1255","NO Perry ",1999,2000,21,21,4,4,4,0,0,3
"1256","MJ Petrie ",2009,2009,4,4,4,3,0,3,1,2
"1257","AM Phangiso ",2013,2016,21,21,4,4,4,0,0,1
"1258","IL Philip ",1999,1999,3,3,4,4,4,0,0,3
"1259","Qasim Umar ",1983,1987,31,30,4,4,4,0,0,1
"1260","V Rathour ",1996,1997,7,7,4,4,4,0,0,2
"1261","PWE Rawson ",1983,1987,10,10,4,4,4,0,0,2
"1262","Raza-ur-Rehman ",2013,2014,6,6,4,4,4,0,0,4
"1263","V Razdan ",1989,1990,3,3,4,4,4,0,0,2
"1264","JA Richardson ",2018,2020,13,13,4,4,4,0,0,1
"1265","MJG Rippon ",2013,2018,6,6,4,4,4,0,0,1
"1266","RD Robinson ",1977,1977,2,2,4,3,0,3,1,4
"1267","RL Sanghvi ",1998,1998,10,10,4,4,4,0,0,2
"1268","Shahid Nazir ",1996,2000,17,17,4,4,4,0,0,1
"1269","A Shahzad ",2010,2011,11,11,4,4,4,0,0,2
"1270","Sikander Bakht ",1977,1989,27,27,4,4,4,0,0,1
"1271","RB Simpson ",1978,1978,2,2,4,4,4,0,0,2
"1272","GM Strydom ",2006,2006,12,12,4,4,4,0,0,2
"1273","Tareq Aziz ",2002,2004,10,10,4,4,4,0,0,1
"1274","R Telemachus ",1998,2006,37,37,4,4,4,0,0,1
"1275","S Thuraisingam ",2003,2008,10,10,4,4,4,0,0,2
"1276","T Thushara ",2008,2010,38,38,4,4,4,0,0,1
"1277","DT Tiripano ",2014,2020,34,33,4,4,4,0,0,1
"1278","MK Tiwary ",2008,2015,12,11,4,4,4,0,0,3
"1279","G Toka ",2019,2019,7,7,4,4,4,0,0,2
"1280","CT Tremlett ",2005,2011,15,15,4,4,4,0,0,1
"1281","RJ Trott ",2007,2009,11,11,4,4,4,0,0,1
"1282","PCR Tufnell ",1990,1997,20,20,4,4,4,0,0,2
"1283","Usman Limbada ",2010,2014,11,11,4,4,4,0,0,2
"1284","RH Vance ",1988,1989,8,8,4,4,4,0,0,2
"1285","RE van der Merwe ",2009,2019,15,15,4,4,4,0,0,1
"1286","M van Jaarsveld ",2002,2004,11,11,4,4,4,0,0,1
"1287","M van Schoor ",2003,2003,5,5,4,4,0,4,0,2
"1288","JTC Vaughan ",1992,1996,18,18,4,4,4,0,0,1
"1289","S Venkataraghavan ",1974,1983,15,15,4,4,4,0,0,1
"1290","R Vijay Bharadwaj ",1999,2002,10,10,4,4,4,0,0,1
"1291","JM Vince ",2015,2019,13,13,4,4,4,0,0,2
"1292","BV Vitori ",2011,2018,24,24,4,4,4,0,0,1
"1293","RM West ",2008,2009,10,9,4,4,4,0,0,1
"1294","P Willey ",1977,1986,26,26,4,4,4,0,0,1
"1295","BA Williams ",2002,2004,25,24,4,4,4,0,0,2
"1296","JW Wilson ",1993,2005,6,6,4,4,4,0,0,2
"1297","Aarif Sheikh ",2018,2020,10,10,3,3,3,0,0,2
"1298","Abid Ali ",2019,2019,4,4,3,3,3,0,0,2
"1299","MR Adair ",2019,2020,12,12,3,3,3,0,0,1
"1300","CJ Adams ",1998,2000,5,5,3,3,3,0,0,1
"1301","Adeel Raja ",2002,2011,21,21,3,3,3,0,0,1
"1302","Adnan Akmal ",2011,2012,5,5,3,3,0,3,0,1
"1303","RG Aga ",2004,2014,12,12,3,3,3,0,0,1
"1304","Aizaz Khan ",2014,2018,19,19,3,3,3,0,0,1
"1305","MW Alleyne ",1999,2000,10,10,3,3,3,0,0,1
"1306","TR Ambrose ",2008,2008,5,5,3,3,0,3,0,1
"1307","J Anderson ",2014,2016,8,8,3,3,3,0,0,2
"1308","KJ Arnott ",1987,1993,13,13,3,3,3,0,0,1
"1309","Azeem Hafeez ",1983,1985,15,15,3,3,3,0,0,2
"1310","SV Bahutule ",1997,2003,8,8,3,3,3,0,0,2
"1311","WD Balaji Rao ",2008,2011,10,10,3,3,3,0,0,1
"1312","ST Banerjee ",1991,1992,6,6,3,3,3,0,0,1
"1313","AB Barath ",2010,2012,14,13,3,3,3,0,0,1
"1314","OO Bascome ",2008,2008,6,6,3,3,3,0,0,1
"1315","JP Behrendorff ",2019,2019,11,11,3,3,3,0,0,1
"1316","DM Benkenstein ",1998,2002,23,23,3,3,3,0,0,1
"1317","HK Bennett ",2010,2020,19,19,3,3,3,0,0,1
"1318","STR Binny ",2014,2015,14,12,3,3,3,0,0,2
"1319","RJ Blakey ",1992,1993,3,3,3,2,0,2,1,2
"1320","SM Boland ",2016,2016,14,14,3,3,3,0,0,1
"1321","LE Bosman ",2006,2010,14,14,3,3,3,0,0,2
"1322","DAJ Bracewell ",2011,2019,19,19,3,3,3,0,0,1
"1323","KC Brathwaite ",2016,2017,10,10,3,3,3,0,0,1
"1324","CPS Chauhan ",1978,1981,7,7,3,3,3,0,0,1
"1325","Chirag Suri ",2018,2020,17,17,3,3,3,0,0,1
"1326","NE Clarke ",1996,1996,5,5,3,3,3,0,0,1
"1327","D Dasgupta ",2001,2001,5,5,3,2,0,2,1,1
"1328","AG Davies ",1999,1999,5,5,3,2,0,2,1,2
"1329","AP Devcich ",2013,2016,12,12,3,3,3,0,0,1
"1330","LHD Dilhara ",2005,2013,9,9,3,3,3,0,0,1
"1331","DR Doshi ",1980,1982,15,15,3,3,3,0,0,1
"1332","Ehsan Khan ",2016,2018,15,15,3,3,3,0,0,2
"1333","CE Eksteen ",1991,1994,6,6,3,3,3,0,0,1
"1334","AM Ellis ",2012,2013,15,15,3,3,3,0,0,2
"1335","PA Emery ",1994,1994,1,1,3,3,0,3,0,3
"1336","JJ Esmeijer ",2002,2003,6,6,3,3,3,0,0,2
"1337","GM Ewing ",2004,2005,7,7,3,3,3,0,0,2
"1338","Faisal Hossain ",2004,2010,6,6,3,3,3,0,0,1
"1339","Faisal Iqbal ",2000,2006,18,18,3,3,3,0,0,1
"1340","TCB Fernando ",2001,2003,17,17,3,3,3,0,0,2
"1341","BT Foakes ",2019,2019,1,1,3,2,0,2,1,3
"1342","CR Foggo ",2008,2008,4,4,3,3,3,0,0,2
"1343","JN Frylinck ",2019,2020,8,8,3,3,3,0,0,2
"1344","OD Gibson ",1995,1997,15,15,3,3,3,0,0,1
"1345","DR Gilbert ",1986,1986,14,14,3,3,3,0,0,1
"1346","AH Gray ",1985,1991,25,25,3,3,3,0,0,1
"1347","EJ Gray ",1984,1988,10,10,3,3,3,0,0,2
"1348","PW Gunaratne ",2002,2003,23,23,3,3,3,0,0,1
"1349","Haroon Rasheed ",1977,1982,12,12,3,3,3,0,0,1
"1350","Hazratullah Zazai ",2018,2019,16,15,3,3,3,0,0,1
"1351","DW Headley ",1996,1999,13,13,3,3,3,0,0,1
"1352","SP Heaney ",2006,2006,4,4,3,3,3,0,0,2
"1353","IG Holland ",2019,2020,8,8,3,3,3,0,0,2
"1354","HJ Howarth ",1973,1975,9,9,3,3,3,0,0,1
"1355","Iftikhar Ahmed ",2015,2019,4,4,3,3,3,0,0,1
"1356","PJ Ingram ",2010,2010,8,8,3,3,3,0,0,1
"1357","Iqbal Qasim ",1977,1988,15,15,3,3,3,0,0,1
"1358","SD Jack ",1994,1995,2,2,3,3,3,0,0,2
"1359","PA Jaques ",2006,2007,6,6,3,3,3,0,0,1
"1360","Joginder Sharma ",2004,2007,4,4,3,3,3,0,0,1
"1361","MA Jones ",2018,2019,8,8,3,3,3,0,0,1
"1362","Junaid Siddiqui ",2011,2014,9,9,3,3,3,0,0,1
"1363","SKW Kelly ",2006,2009,10,10,3,3,3,0,0,1
"1364","D Keulder ",2003,2003,6,6,3,3,3,0,0,2
"1365","AR Khurasiya ",1999,2001,12,12,3,3,3,0,0,1
"1366","Khurram Chohan ",2009,2014,25,24,3,3,3,0,0,1
"1367","Khurram Manzoor ",2008,2009,7,7,3,3,3,0,0,1
"1368","BA King ",2019,2020,4,4,3,3,3,0,0,1
"1369","LJ Koen ",1997,2000,5,5,3,3,3,0,0,2
"1370","DB Kotze ",2003,2003,6,6,3,3,3,0,0,1
"1371","AP Kuiper ",1991,1996,25,25,3,3,3,0,0,1
"1372","CBRLS Kumara ",2017,2019,13,13,3,3,3,0,0,1
"1373","T Kumaran ",1999,2000,8,8,3,3,3,0,0,1
"1374","JL Langer ",1994,1997,8,8,3,2,1,1,1,1
"1375","D Lloyd ",1973,1980,8,8,3,3,3,0,0,1
"1376","BP Loots ",2010,2011,7,7,3,3,3,0,0,2
"1377","CA Lynn ",2017,2018,4,4,3,3,3,0,0,2
"1378","RB McCosker ",1975,1982,14,14,3,3,3,0,0,1
"1379","AJ McKay ",2010,2012,19,19,3,3,3,0,0,1
"1380","N Madziva ",2014,2016,12,12,3,3,3,0,0,1
"1381","MAWR Madurasinghe ",1988,1992,12,12,3,3,3,0,0,1
"1382","Majid Khan ",1973,1982,23,23,3,3,3,0,0,1
"1383","JN Malan ",2020,2020,3,3,3,3,3,0,0,3
"1384","G Malla ",2018,2020,10,10,3,3,3,0,0,1
"1385","A Martin ",2011,2011,9,9,3,3,3,0,0,1
"1386","TBA May ",1987,1995,47,47,3,3,3,0,0,2
"1387","M Mbangwa ",1996,2002,29,29,3,3,3,0,0,1
"1388","Mohammad Nadeem ",2019,2020,10,10,3,3,3,0,0,1
"1389","Mohammad Saifuddin ",2017,2020,22,22,3,3,3,0,0,1
"1390","JN Mohammed ",2011,2018,28,27,3,3,3,0,0,1
"1391","R Murray ",2018,2018,5,5,3,3,0,3,0,1
"1392","Mushtaq Mohammad ",1973,1978,10,10,3,3,3,0,0,1
"1393","JD Nel ",2006,2010,19,19,3,3,3,0,0,1
"1394","RAP Nissanka ",2001,2003,23,23,3,3,3,0,0,1
"1395","Nurul Hasan ",2016,2016,2,2,3,2,0,2,1,3
"1396","LN Onyango ",1996,2014,29,29,3,3,3,0,0,1
"1397","ARM Opatha ",1975,1979,5,5,3,3,3,0,0,2
"1398","MS Panesar ",2007,2007,26,26,3,3,3,0,0,1
"1399","MA Parker ",2010,2010,10,10,3,3,3,0,0,1
"1400","JL Pattinson ",2011,2015,15,15,3,3,3,0,0,1
"1401","RK Paudel ",2018,2020,5,5,3,3,3,0,0,1
"1402","RR Powar ",2004,2007,31,30,3,3,3,0,0,1
"1403","MR Pydanna ",1980,1983,3,3,3,2,0,2,1,1
"1404","S Ramesh ",1999,1999,24,23,3,3,3,0,0,1
"1405","SHA Rance ",2017,2017,2,2,3,3,3,0,0,3
"1406","Rashid Khan ",1980,1985,29,28,3,3,3,0,0,1
"1407","AJ Redmond ",2009,2010,6,6,3,3,3,0,0,1
"1408","RB Reid ",1988,1991,9,9,3,3,3,0,0,1
"1409","FL Reifer ",1997,2009,8,8,3,3,3,0,0,1
"1410","GR Robertson ",1994,1998,13,13,3,3,3,0,0,1
"1411","DB Rundle ",1994,1994,2,2,3,3,3,0,0,2
"1412","NA Saini ",2019,2020,5,5,3,3,3,0,0,2
"1413","Saleem Jaffar ",1986,1990,39,39,3,3,3,0,0,1
"1414","DP Samaraweera ",1993,1994,5,5,3,3,3,0,0,2
"1415","MMC Schewe ",1996,1996,5,5,3,2,0,2,1,3
"1416","E Schiferli ",2002,2013,30,30,3,3,3,0,0,1
"1417","Shamsur Rahman ",2013,2014,10,10,3,3,3,0,0,2
"1418","MD Shanaka ",2016,2019,22,22,3,3,3,0,0,1
"1419","KV Sharma ",2014,2014,2,2,3,3,3,0,0,2
"1420","VRV Singh ",2006,2006,2,2,3,3,3,0,0,2
"1421","TT Smart ",2004,2004,2,2,3,3,1,2,0,2
"1422","CJ Smith ",2006,2007,12,12,3,3,3,0,0,2
"1423","S Snater ",2018,2018,2,2,3,3,3,0,0,2
"1424","Sohail Khan ",2008,2016,13,13,3,3,3,0,0,1
"1425","CB Sole ",2016,2018,11,11,3,3,3,0,0,2
"1426","MC Sorensen ",2013,2016,13,12,3,3,3,0,0,1
"1427","DA Stirling ",1984,1984,6,6,3,3,3,0,0,1
"1428","PC Strydom ",2000,2000,10,10,3,3,3,0,0,2
"1429","R Strydom ",2008,2008,9,8,3,3,3,0,0,1
"1430","Tanveer Ahmed ",2016,2018,6,6,3,3,3,0,0,2
"1431","Tanwir Afzal ",2014,2018,20,20,3,3,3,0,0,1
"1432","APB Tennekoon ",1975,1979,4,4,3,3,3,0,0,1
"1433","SN Thakur ",2017,2020,11,11,3,3,3,0,0,1
"1434","AJ Traicos ",1983,1993,27,27,3,3,3,0,0,1
"1435","A Turner ",1975,1975,6,6,3,3,3,0,0,2
"1436","Usman Ghani ",2014,2017,15,15,3,3,3,0,0,1
"1437","Usman Shinwari ",2017,2019,17,17,3,3,3,0,0,2
"1438","JJ van der Wath ",2006,2007,10,10,3,3,3,0,0,1
"1439","K Verreynne ",2020,2020,3,3,3,3,3,0,0,3
"1440","GR Viswanath ",1974,1982,25,25,3,3,3,0,0,1
"1441","Waheed Ahmed ",2019,2020,5,5,3,3,3,0,0,1
"1442","Waqas Barkat ",2014,2018,10,10,3,3,3,0,0,1
"1443","SM Warnapura ",2007,2008,3,3,3,3,3,0,0,2
"1444","PN Webb ",1983,1984,5,5,3,3,0,3,0,1
"1445","K Weeraratne ",2000,2008,15,15,3,3,3,0,0,1
"1446","DS Wesonga ",2010,2011,4,4,3,3,3,0,0,2
"1447","S Wettimuny ",1982,1987,35,35,3,3,3,0,0,1
"1448","BTJ Wheal ",2016,2019,13,13,3,3,3,0,0,1
"1449","SG Whittingham ",2017,2019,5,5,3,3,3,0,0,1
"1450","KIW Wijegunawardene ",1988,1992,26,26,3,3,3,0,0,1
"1451","RA Woolmer ",1972,1976,6,6,3,3,3,0,0,1
"1452","Jai P Yadav ",2002,2005,12,12,3,3,3,0,0,2
"1453","Zahoor Khan ",2017,2019,17,17,3,3,3,0,0,1
"1454","M Zondeki ",2002,2008,13,13,3,3,3,0,0,1
"1455","Aamir Kaleem ",2019,2019,2,2,2,2,2,0,0,1
"1456","Aaron Jones ",2019,2020,13,13,2,2,2,0,0,1
"1457","Abdur Rauf ",2008,2008,4,4,2,2,2,0,0,1
"1458","Aizaz Cheema ",2011,2012,14,14,2,2,2,0,0,1
"1459","PJW Allott ",1982,1985,13,13,2,2,2,0,0,1
"1460","SW Ambris ",2017,2020,13,13,2,2,2,0,0,1
"1461","DL Amiss ",1972,1977,18,17,2,2,2,0,0,1
"1462","JO Angara ",1997,2003,17,17,2,2,2,0,0,1
"1463","SA Ankola ",1989,1997,20,20,2,2,2,0,0,1
"1464","GG Arnold ",1972,1975,14,13,2,2,2,0,0,1
"1465","TD Astle ",2017,2019,9,9,2,2,2,0,0,1
"1466","Athar Ali Khan ",1988,1998,19,19,2,2,2,0,0,1
"1467","Azam Khan ",1996,1998,6,6,2,2,2,0,0,1
"1468","Azhar Hossain ",1988,1990,7,7,2,2,2,0,0,1
"1469","Azhar Saeed ",1994,1996,7,7,2,2,2,0,0,1
"1470","SJ Baard ",2019,2020,8,8,2,2,2,0,0,1
"1471","Badal Singh ",2020,2020,2,2,2,2,2,0,0,2
"1472","S Badrinath ",2008,2011,7,7,2,2,2,0,0,2
"1473","IPP Batuwitarachchi ",2008,2008,2,2,2,2,2,0,0,2
"1474","AR Berenger ",2014,2015,10,10,2,2,2,0,0,1
"1475","RA Bhatti ",2011,2011,1,1,2,2,0,2,0,2
"1476","RL Bhudia ",2008,2009,5,5,2,2,2,0,0,1
"1477","MP Bicknell ",1990,1991,7,7,2,2,2,0,0,1
"1478","Bilal Asif ",2015,2015,3,3,2,2,2,0,0,2
"1479","Bilawal Bhatti ",2013,2015,10,10,2,2,2,0,0,1
"1480","DCC Borden ",2006,2008,12,12,2,2,2,0,0,1
"1481","GE Bradburn ",1990,2001,11,11,2,2,2,0,0,1
"1482","RJ Bright ",1974,1986,11,11,2,2,2,0,0,1
"1483","VR Brown ",1988,1988,3,3,2,2,2,0,0,1
"1484","PA Browne ",2008,2008,5,5,2,2,0,2,0,1
"1485","MG Burmester ",1992,1995,8,8,2,2,2,0,0,1
"1486","JA Burns ",2015,2015,6,6,2,2,2,0,0,1
"1487","IW Callen ",1978,1982,5,5,2,2,2,0,0,1
"1488","J Cameron-Dow ",2019,2019,4,4,2,2,2,0,0,1
"1489","MA Carberry ",2013,2014,6,5,2,2,2,0,0,1
"1490","JJ Celestine ",2007,2008,8,8,2,2,2,0,0,1
"1491","DR Chumney ",2003,2007,21,21,2,2,2,0,0,1
"1492","PG Coman ",1973,1974,3,3,2,2,2,0,0,1
"1493","G Cook ",1981,1983,6,6,2,2,2,0,0,1
"1494","NGB Cook ",1984,1989,3,3,2,2,2,0,0,1
"1495","BN Cooper ",2013,2019,8,8,2,2,2,0,0,1
"1496","JP Crawley ",1994,1999,13,13,2,1,1,0,1,1
"1497","DJ Cullen ",2006,2006,5,5,2,2,2,0,0,1
"1498","D Daesrath ",2012,2013,4,4,2,2,2,0,0,2
"1499","Danish Kaneria ",2001,2007,18,18,2,2,2,0,0,1
"1500","HT Davis ",1994,1997,11,11,2,2,2,0,0,1
"1501","AC Dawson ",1998,2004,19,19,2,2,2,0,0,1
"1502","RP de Groen ",1993,1994,12,12,2,2,2,0,0,1
"1503","PA Desai ",2010,2014,13,13,2,2,2,0,0,1
"1504","GRA de Silva ",1975,1982,6,6,2,2,2,0,0,1
"1505","MW Douglas ",1994,1995,6,6,2,2,2,0,0,1
"1506","TM Dowlin ",2009,2010,11,11,2,2,2,0,0,1
"1507","KG Duers ",1992,1992,6,6,2,2,2,0,0,1
"1508","SF Dukanwala ",1996,1996,5,5,2,2,2,0,0,1
"1509","CI Dunusinghe ",1995,1995,1,1,2,1,0,1,1,2
"1510","NR Dyer ",1999,1999,5,5,2,2,2,0,0,1
"1511","KA Edwards ",2011,2014,16,16,2,2,2,0,0,1
"1512","Ehsan Nawaz ",2014,2018,12,12,2,2,2,0,0,1
"1513","RM Ellison ",1984,1986,14,14,2,2,2,0,0,2
"1514","EA Essop-Adam ",1992,1992,1,1,2,2,2,0,0,2
"1515","Fahim Muntasir ",2001,2002,3,3,2,2,2,0,0,1
"1516","Fareed Ahmad ",2014,2017,5,4,2,2,2,0,0,1
"1517","Faruk Ahmed ",1988,1999,7,7,2,2,2,0,0,1
"1518","Fayyaz Butt ",2019,2019,5,5,2,2,2,0,0,1
"1519","KHRK Fernando ",2002,2006,7,7,2,2,2,0,0,1
"1520","AN French ",2004,2004,2,2,2,2,2,0,0,1
"1521","D Gamage ",2003,2003,3,3,2,2,2,0,0,1
"1522","JC Gamage ",1995,1995,4,4,2,2,2,0,0,1
"1523","PLS Gamage ",2014,2017,9,9,2,2,2,0,0,1
"1524","KD Ghavri ",1975,1981,19,19,2,2,2,0,0,1
"1525","GJ Gilmour ",1974,1975,5,5,2,2,2,0,0,1
"1526","DM Gondaria ",2013,2013,2,2,2,2,2,0,0,1
"1527","TG Gordon ",2011,2011,5,5,2,2,2,0,0,1
"1528","K Gore ",2019,2020,10,10,2,2,2,0,0,1
"1529","Z Groenewald ",2019,2019,4,4,2,2,2,0,0,1
"1530","TGJ Gruijters ",2010,2013,5,5,2,2,2,0,0,1
"1531","DR Hadlee ",1973,1976,11,11,2,2,2,0,0,1
"1532","Hafizur Rahman ",1986,1986,2,2,2,2,0,2,0,1
"1533","PL Harris ",2008,2008,3,3,2,2,2,0,0,1
"1534","C Hemraj ",2018,2018,6,6,2,2,2,0,0,2
"1535","BE Hendricks ",2019,2020,7,5,2,2,2,0,0,1
"1536","RO Hinds ",2001,2004,14,14,2,2,2,0,0,1
"1537","ND Hirwani ",1988,1992,18,18,2,2,2,0,0,1
"1538","LG Howell ",1998,1998,12,12,2,2,2,0,0,1
"1539","GW Humpage ",1981,1981,3,3,2,2,0,2,0,1
"1540","EH Hutchinson ",2019,2020,6,6,2,2,2,0,0,1
"1541","N Ifill ",2003,2006,4,4,2,2,2,0,0,1
"1542","Ijaz Faqih ",1980,1988,27,27,2,2,2,0,0,1
"1543","IT Iqbal ",1996,1996,3,3,2,2,0,2,0,2
"1544","AJ Ireland ",2005,2007,26,26,2,2,2,0,0,1
"1545","Irfan Ahmed ",2008,2014,6,6,2,2,2,0,0,2
"1546","KA Jamieson ",2020,2020,2,2,2,2,2,0,0,2
"1547","LR Johnson ",2008,2015,6,6,2,2,2,0,0,1
"1548","SMS Kaluperuma ",1988,1988,2,2,2,2,2,0,0,1
"1549","FJ Klaassen ",2018,2019,4,4,2,2,2,0,0,2
"1550","JJ Krejza ",2011,2011,8,8,2,2,2,0,0,1
"1551","P Krishnamurthy ",1976,1976,1,1,2,1,0,1,1,2
"1552","N Kruger ",2011,2011,2,2,2,2,2,0,0,2
"1553","DS Kulkarni ",2014,2016,12,12,2,2,2,0,0,1
"1554","NM Kulkarni ",1997,1998,10,10,2,2,2,0,0,1
"1555","RR Kulkarni ",1983,1987,10,10,2,2,2,0,0,1
"1556","S Lamichhane ",2018,2020,10,10,2,2,2,0,0,1
"1557","B Laughlin ",2009,2009,5,5,2,2,2,0,0,1
"1558","P Lever ",1971,1975,10,9,2,2,2,0,0,1
"1559","GD Lloyd ",1996,1998,6,6,2,2,2,0,0,1
"1560","SCG MacGill ",2000,2000,3,3,2,2,2,0,0,1
"1561","BJ McKechnie ",1975,1981,14,14,2,2,2,0,0,1
"1562","KH MacLeay ",1983,1987,16,16,2,2,2,0,0,1
"1563","TN Madondo ",1998,2001,13,13,2,2,2,0,0,1
"1564","JN Maguire ",1983,1984,23,21,2,2,2,0,0,1
"1565","I Maraj ",2003,2003,6,6,2,2,2,0,0,1
"1566","A Maregwede ",2003,2005,11,11,2,2,2,0,0,1
"1567","EH Mattis ",1981,1981,2,2,2,2,2,0,0,1
"1568","B Mavuta ",2018,2019,7,7,2,2,2,0,0,1
"1569","TMK Mawoyo ",2006,2014,7,7,2,2,2,0,0,1
"1570","MC Mendis ",1995,1995,1,1,2,2,2,0,0,2
"1571","Minhajul Abedin ",1986,1999,27,27,2,2,2,0,0,1
"1572","Mohammad Kashif ",2006,2010,11,11,2,2,2,0,0,1
"1573","Mohammad Khalil ",2005,2005,3,3,2,2,2,0,0,1
"1574","Mohammad Naim ",2020,2020,1,1,2,2,2,0,0,2
"1575","Mohammad Shahzad ",2014,2016,6,6,2,2,2,0,0,1
"1576","Mohammed Qasim ",2017,2017,5,5,2,2,2,0,0,1
"1577","Mohibullah Oryakhel ",2013,2013,2,2,2,2,2,0,0,1
"1578","GMC Mol ",2007,2008,6,6,2,2,2,0,0,2
"1579","HJC Mol ",2002,2008,11,11,2,2,2,0,0,1
"1580","PJK Mooney ",2006,2007,4,4,2,2,2,0,0,2
"1581","JE Morris ",1990,1991,8,8,2,2,2,0,0,1
"1582","Morshed Ali Khan ",1998,1998,3,3,2,2,2,0,0,1
"1583","JK Moss ",1979,1979,1,1,2,2,2,0,0,2
"1584","EMDY Munaweera ",2017,2017,2,2,2,2,2,0,0,1
"1585","W Mwayenga ",2002,2004,3,3,2,2,2,0,0,1
"1586","SJ Myburgh ",2011,2018,13,13,2,2,2,0,0,1
"1587","Nafees Iqbal ",2003,2005,16,16,2,2,2,0,0,1
"1588","PG Nana ",1975,1975,3,3,2,2,2,0,0,1
"1589","Nasir Ahmed ",1988,1990,7,7,2,1,0,1,1,1
"1590","Naved Latif ",2001,2003,11,11,2,2,2,0,0,1
"1591","Naveen-ul-Haq ",2016,2019,4,4,2,2,2,0,0,1
"1592","Najmul Hossain Shanto ",2018,2020,5,5,2,2,2,0,0,2
"1593","Nazmul Islam ",2018,2018,5,5,2,2,2,0,0,1
"1594","TS Nethula ",2012,2012,5,5,2,2,2,0,0,1
"1595","A Nortje ",2019,2020,7,7,2,2,2,0,0,2
"1596","MP O'Dowd ",2019,2019,2,2,2,2,2,0,0,1
"1597","FN Otieno ",2010,2010,4,4,2,2,2,0,0,1
"1598","C Overton ",2018,2018,1,1,2,2,2,0,0,2
"1599","JV Paranjpe ",1998,1998,4,4,2,2,2,0,0,1
"1600","TK Patel ",2019,2020,7,7,2,2,2,0,0,1
"1601","D Paterson ",2017,2019,4,4,2,2,2,0,0,2
"1602","GA Paterson ",1983,1987,10,10,2,2,2,0,0,1
"1603","MDK Perera ",2007,2018,13,12,2,2,2,0,0,1
"1604","PDRL Perera ",1999,2007,19,19,2,2,2,0,0,1
"1605","Pervez Mir ",1975,1977,3,3,2,2,2,0,0,1
"1606","RG Petrie ",1990,1991,12,12,2,2,2,0,0,1
"1607","OL Pitcher ",2007,2007,5,5,2,2,2,0,0,1
"1608","MW Priest ",1990,1998,18,18,2,2,2,0,0,1
"1609","MW Pringle ",1992,1994,17,17,2,2,2,0,0,1
"1610","PM Pushpakumara ",2017,2017,2,2,2,2,2,0,0,1
"1611","NV Radford ",1988,1988,6,6,2,2,2,0,0,2
"1612","Raees Ahmadzai ",2009,2010,5,5,2,2,2,0,0,1
"1613","LS Rajput ",1985,1987,4,4,2,2,2,0,0,1
"1614","WV Raman ",1988,1996,27,27,2,2,2,0,0,1
"1615","S Ranatunga ",1994,1996,13,13,2,2,2,0,0,1
"1616","D Ravu ",2017,2019,8,8,2,2,2,0,0,1
"1617","B Reddy ",1978,1981,3,3,2,2,0,2,0,1
"1618","IR Redpath ",1971,1975,5,5,2,2,2,0,0,1
"1619","CP Rizwan ",2019,2020,9,9,2,2,2,0,0,1
"1620","Rizwan-uz-Zaman ",1981,1987,3,3,2,2,2,0,0,2
"1621","GK Robertson ",1981,1989,10,10,2,2,2,0,0,1
"1622","GA Rogers ",2006,2008,13,12,2,2,2,0,0,1
"1623","GRJ Roope ",1973,1978,8,7,2,2,2,0,0,1
"1624","LG Rowe ",1975,1980,11,11,2,2,2,0,0,1
"1625","Rumman Raees ",2017,2018,9,9,2,2,2,0,0,1
"1626","HD Rutherford ",2013,2013,4,4,2,2,2,0,0,1
"1627","Saeed Azad ",1995,1996,4,4,2,2,2,0,0,1
"1628","AK Sah ",2018,2018,2,2,2,2,0,2,0,2
"1629","AM Salvi ",2003,2003,4,4,2,2,2,0,0,1
"1630","Sameer Zia ",2004,2004,1,1,2,2,2,0,0,2
"1631","Saqib Ali ",2008,2014,5,5,2,2,2,0,0,1
"1632","Saqlain Haider ",2014,2016,5,5,2,1,0,1,1,1
"1633","Sarandeep Singh ",2002,2003,5,5,2,2,2,0,0,1
"1634","AF Sattaur ",2003,2003,3,3,2,2,2,0,0,2
"1635","BM Scholtz ",2019,2020,8,8,2,2,2,0,0,2
"1636","S Seeraj ",2006,2006,1,1,2,2,0,2,0,2
"1637","KF Semple ",1999,1999,7,7,2,2,2,0,0,1
"1638","CP Senanayake ",1990,1991,7,7,2,2,2,0,0,1
"1639","Shaheen Shah Afridi ",2018,2019,19,18,2,2,2,0,0,1
"1640","Shahid Saeed ",1989,1993,10,10,2,2,2,0,0,1
"1641","Shahid Wasif ",2016,2018,10,10,2,2,2,0,0,1
"1642","G Sharma ",1985,1987,11,11,2,2,2,0,0,1
"1643","TG Shaw ",1991,1994,9,9,2,2,2,0,0,1
"1644","MQ Sheikh ",2008,2010,7,7,2,2,2,0,0,1
"1645","R Shepherd ",2019,2020,5,5,2,2,2,0,0,1
"1646","IT Shillingford ",1978,1978,2,2,2,2,2,0,0,1
"1647","DJM Short ",2018,2020,8,8,2,2,2,0,0,1
"1648","JT Smuts ",2020,2020,5,4,2,2,2,0,0,2
"1649","ED Solkar ",1974,1976,7,7,2,2,2,0,0,1
"1650","IM Stanger ",1999,2006,5,5,2,2,2,0,0,1
"1651","CAH Stevenson ",2019,2020,7,7,2,2,2,0,0,1
"1652","GB Stevenson ",1980,1981,4,4,2,2,2,0,0,1
"1653","AM Stuart ",1997,1997,3,3,2,2,2,0,0,2
"1654","Taslim Arif ",1980,1980,2,2,2,1,1,0,1,1
"1655","SP Terry ",2016,2016,5,5,2,2,2,0,0,2
"1656","LO Tikolo ",1996,1996,3,3,2,2,2,0,0,1
"1657","SS Tiwary ",2010,2010,3,3,2,2,2,0,0,1
"1658","RJW Topley ",2015,2016,10,10,2,2,2,0,0,1
"1659","GB Troup ",1976,1985,22,22,2,2,2,0,0,1
"1660","TE Tucker ",2008,2009,5,5,2,2,2,0,0,1
"1661","AJ Turner ",2019,2020,6,6,2,2,2,0,0,1
"1662","KEA Upashantha ",1995,2001,12,12,2,2,2,0,0,1
"1663","PS Vaidya ",1995,1996,4,4,2,2,2,0,0,1
"1664","JDF Vandersay ",2015,2019,12,12,2,2,2,0,0,1
"1665","RF van Oosterom ",1996,2002,3,3,2,2,2,0,0,1
"1666","C Viljoen ",2019,2019,2,2,2,2,2,0,0,2
"1667","KDK Vithanage ",2013,2014,6,6,2,2,2,0,0,1
"1668","MDJ Walker ",2003,2003,3,3,2,2,2,0,0,1
"1669","HR Walsh ",2019,2020,10,10,2,2,2,0,0,1
"1670","KPJ Warnaweera ",1990,1993,6,6,2,2,2,0,0,1
"1671","AS Wassan ",1990,1991,9,9,2,2,2,0,0,1
"1672","DS Weerakkody ",2017,2017,3,3,2,2,2,0,0,1
"1673","UWMBCA Welegedara ",2009,2010,10,9,2,2,2,0,0,1
"1674","JM Wiener ",1979,1980,7,7,2,2,2,0,0,1
"1675","RGCE Wijesuriya ",1982,1985,8,8,2,2,2,0,0,1
"1676","HS Williams ",1999,2000,7,7,2,2,2,0,0,2
"1677","PJ Wiseman ",1998,2003,15,14,2,2,2,0,0,1
"1678","RD Woolley ",1983,1983,4,2,2,1,0,1,1,2
"1679","Yamin Ahmadzai ",2015,2019,4,4,2,2,2,0,0,1
"1680","Yasir Arafat ",2000,2009,11,11,2,2,2,0,0,1
"1681","B Yograj Singh ",1980,1981,6,6,2,2,2,0,0,1
"1682","BE Young ",1998,1999,6,6,2,2,2,0,0,1
"1683","CA Young ",2014,2020,14,13,2,2,2,0,0,1
"1684","Zahid Fazal ",1990,1994,19,19,2,2,2,0,0,1
"1685","Zahoor Elahi ",1996,1997,14,14,2,2,2,0,0,1
"1686","Zulqarnain Haider ",2010,2010,4,4,2,1,0,1,1,2
"1687","NP Kenjige ",2019,2020,5,5,1,1,1,0,0,1
"1688","Aamer Hameed ",1977,1978,2,2,1,1,1,0,0,1
"1689","VR Aaron ",2011,2014,9,9,1,1,1,0,0,1
"1690","JS Ababu ",1999,2006,9,9,1,1,1,0,0,1
"1691","Abdullah Mazari ",2010,2010,2,2,1,1,1,0,0,1
"1692","Abdul Jabbar ",2007,2007,2,2,1,1,1,0,0,1
"1693","S Abrahams ",2000,2000,1,1,1,1,1,0,0,1
"1694","Abul Hasan ",2012,2018,7,7,1,1,1,0,0,1
"1695","Abu Hider ",2018,2018,2,2,1,1,1,0,0,1
"1696","Afzaal Haider ",2004,2008,4,4,1,1,1,0,0,1
"1697","MA Agarwal ",2020,2020,3,3,1,1,1,0,0,1
"1698","JP Agnew ",1985,1985,3,3,1,1,1,0,0,1
"1699","KK Ahmed ",2018,2019,11,11,1,1,1,0,0,1
"1700","Aijaz Ali ",2004,2004,2,2,1,1,1,0,0,1
"1701","Kabir Ali ",2003,2006,14,13,1,1,1,0,0,1
"1702","RW Ali ",1996,1997,9,9,1,1,1,0,0,1
"1703","DI Allan ",2011,2013,5,5,1,1,1,0,0,1
"1704","MJD Allingham ",1999,1999,3,3,1,1,1,0,0,1
"1705","Al-Amin Hossain ",2014,2020,15,15,1,1,1,0,0,1
"1706","S Amarnath ",1978,1978,3,3,1,1,1,0,0,1
"1707","MKDI Amerasinghe ",2007,2008,8,8,1,1,1,0,0,1
"1708","CR Amini ",2014,2014,2,2,1,1,1,0,0,1
"1709","RW Anderson ",1976,1978,2,2,1,1,1,0,0,1
"1710","Ankur Vasishta ",2014,2014,4,4,1,1,1,0,0,1
"1711","Arshad Ali ",2004,2008,4,4,1,1,1,0,0,1
"1712","Arshad Laeeq ",1994,1996,6,6,1,1,1,0,0,1
"1713","Asif Masood ",1973,1976,7,7,1,1,1,0,0,1
"1714","RJ Bailey ",1985,1990,4,4,1,1,1,0,0,1
"1715","LS Baker ",2008,2009,10,9,1,1,1,0,0,1
"1716","Basil Hameed ",2019,2020,6,6,1,1,1,0,0,1
"1717","TC Bastiampillai ",2007,2014,13,13,1,1,1,0,0,1
"1718","MD Bates ",2012,2012,2,2,1,1,1,0,0,1
"1719","Bazid Khan ",2004,2008,5,5,1,1,1,0,0,1
"1720","MD Bell ",1998,2001,7,7,1,1,1,0,0,1
"1721","MJ Bennett ",1984,1985,8,8,1,1,1,0,0,1
"1722","Bilal Khan ",2019,2020,10,10,1,1,1,0,0,1
"1723","K Birkenstock ",2019,2020,8,8,1,1,1,0,0,1
"1724","GA Bishop ",1987,1987,2,2,1,1,1,0,0,1
"1725","J Blackwood ",2015,2015,2,2,1,1,1,0,0,1
"1726","TA Blundell ",2020,2020,2,2,1,1,1,0,0,1
"1727","GH Bodi ",2007,2007,2,2,1,1,1,0,0,1
"1728","JWHD Boteju ",1999,1999,2,2,1,1,1,0,0,1
"1729","JE Brinkley ",1999,1999,5,5,1,1,1,0,0,1
"1730","RE Bryson ",1997,1997,7,7,1,1,1,0,0,1
"1731","CE Bulfin ",1999,1999,4,4,1,1,1,0,0,1
"1732","SF Burger ",2003,2003,2,2,1,1,1,0,0,1
"1733","SJ Cameron ",2018,2018,2,2,1,1,1,0,0,1
"1734","TK Canning ",2003,2005,4,4,1,1,1,0,0,1
"1735","HWR Cartwright ",2017,2017,2,2,1,1,1,0,0,1
"1736","MS Chapman ",2015,2020,6,6,1,1,1,0,0,1
"1737","U Chatterjee ",1995,1995,3,3,1,1,1,0,0,1
"1738","DB Close ",1972,1972,3,3,1,1,1,0,0,1
"1739","RO Collinge ",1973,1978,15,15,1,1,1,0,0,1
"1740","PC Connell ",2008,2010,13,12,1,1,1,0,0,1
"1741","SJ Cook ",1991,1993,4,4,1,1,1,0,0,1
"1742","GJ Crocker ",1992,1993,6,6,1,1,1,0,0,1
"1743","CEH Croft ",1977,1981,19,19,1,1,1,0,0,1
"1744","ML Cummins ",2014,2017,11,10,1,1,1,0,0,1
"1745","KM Curran ",1983,1987,11,11,1,1,1,0,0,1
"1746","BCJ Cutting ",2013,2014,4,4,1,1,1,0,0,1
"1747","DDP D'Silva ",2019,2020,6,6,1,1,1,0,0,1
"1748","CJ Dala ",2018,2018,2,2,1,1,1,0,0,1
"1749","WW Davis ",1983,1988,35,35,1,1,1,0,0,1
"1750","BFW de Leede ",2018,2019,3,3,1,1,1,0,0,1
"1751","MH Denness ",1973,1975,12,12,1,1,1,0,0,1
"1752","JH Desai ",2004,2004,1,1,1,1,1,0,0,1
"1753","DLS de Silva ",1979,1979,2,2,1,1,1,0,0,1
"1754","R Dhanraj ",1994,1995,6,6,1,1,1,0,0,1
"1755","BJ Diamanti ",2009,2009,1,1,1,1,1,0,0,1
"1756","AB Dinda ",2010,2013,13,13,1,1,1,0,0,1
"1757","MJ Di Venuto ",1997,1997,9,9,1,1,1,0,0,1
"1758","BL D'Oliveira ",1971,1972,4,4,1,1,1,0,0,1
"1759","CJ Drum ",1999,1999,5,5,1,1,1,0,0,1
"1760","G Dymock ",1974,1980,15,14,1,1,1,0,0,1
"1761","RR Emrit ",2007,2007,2,2,1,1,1,0,0,1
"1762","Fahad Usman ",2004,2004,2,2,1,1,1,0,0,1
"1763","Fazle Mahmud ",2018,2018,2,2,1,1,1,0,0,1
"1764","BOP Fernando ",2019,2019,6,6,1,1,1,0,0,1
"1765","KADM Fernando ",2003,2003,1,1,1,1,1,0,0,1
"1766","J Figy ",2019,2020,2,2,1,1,1,0,0,1
"1767","MV Fleming ",1997,1998,11,11,1,1,1,0,0,1
"1768","MJ Fourie ",2007,2008,7,6,1,1,1,0,0,1
"1769","PJ Franks ",2000,2000,1,1,1,1,1,0,0,1
"1770","RS Gabriel ",1984,1984,11,11,1,1,1,0,0,1
"1771","ST Gabriel ",2016,2019,25,25,1,1,1,0,0,1
"1772","WCA Ganegama ",2001,2006,4,4,1,1,1,0,0,1
"1773","TN Garwe ",2009,2009,1,1,1,1,1,0,0,1
"1774","SP Gauchan ",2018,2018,1,1,1,1,1,0,0,1
"1775","Gazi Ashraf ",1986,1990,7,7,1,1,1,0,0,1
"1776","B Geeves ",2008,2009,2,2,1,1,1,0,0,1
"1777","SC Getkate ",2019,2019,3,3,1,1,1,0,0,1
"1778","N Gifford ",1985,1985,2,2,1,1,1,0,0,1
"1779","BD Glover ",2019,2019,1,1,1,1,1,0,0,1
"1780","SF Graf ",1980,1981,11,11,1,1,1,0,0,1
"1781","AP Grayson ",2000,2001,2,2,1,1,1,0,0,1
"1782","Gurkeerat Singh ",2016,2016,3,3,1,1,1,0,0,1
"1783","HF Gurney ",2014,2014,10,10,1,1,1,0,0,1
"1784","Gursharan Singh ",1990,1990,1,1,1,1,1,0,0,1
"1785","AM Guruge ",2014,2015,7,7,1,1,1,0,0,1
"1786","RS Haire ",2008,2008,2,2,1,1,1,0,0,1
"1787","JV Harris ",2003,2003,6,6,1,1,1,0,0,1
"1788","RG Hart ",2002,2002,2,2,1,1,0,1,0,1
"1789","Hasan Jamil ",1977,1978,6,6,1,1,1,0,0,1
"1790","Hasan Raza ",1996,1999,16,15,1,1,1,0,0,1
"1791","TJ Heggelman ",2010,2011,5,5,1,1,1,0,0,1
"1792","O Henry ",1992,1992,3,3,1,1,1,0,0,1
"1793","JG Heron ",1983,1983,6,6,1,1,1,0,0,1
"1794","PD Heyn ",1975,1975,2,2,1,1,1,0,0,1
"1795","AMJ Hilditch ",1979,1985,8,8,1,1,1,0,0,1
"1796","KC Hodsoll ",2007,2008,3,3,1,1,1,0,0,1
"1797","CK Hooper ",2007,2010,5,5,1,1,1,0,0,1
"1798","KA Hope ",2017,2017,7,7,1,1,1,0,0,1
"1799","AG Hurst ",1975,1979,8,7,1,1,1,0,0,1
"1800","RO Hussain ",2006,2010,8,7,1,1,1,0,0,1
"1801","KH Butt ",2008,2008,2,2,1,1,1,0,0,1
"1802","DP Hyatt ",2011,2011,9,9,1,1,1,0,0,1
"1803","Ibrahim Zadran ",2019,2019,1,1,1,1,1,0,0,1
"1804","AP Igglesden ",1994,1994,4,4,1,1,1,0,0,1
"1805","Ijaz Ahmed jnr ",1997,1997,2,2,1,1,1,0,0,1
"1806","R Illingworth ",1971,1973,3,2,1,1,1,0,0,1
"1807","Imran Abbas ",2000,2000,2,2,1,1,1,0,0,1
"1808","MM Iqbal ",2009,2014,13,13,1,1,1,0,0,1
"1809","Irfan Bhatti ",1993,1993,1,1,1,1,1,0,0,1
"1810","Izatullah Dawlatzai ",2010,2015,5,5,1,1,1,0,0,1
"1811","Jahangir Alam ",1997,1999,3,3,1,0,0,0,1,1
"1812","Jahangir Shah ",1986,1990,5,5,1,1,1,0,0,1
"1813","Jalal-ud-Din ",1982,1983,8,7,1,1,1,0,0,1
"1814","Jamaluddin Ahmed ",2003,2003,1,1,1,1,1,0,0,1
"1815","F Jansen ",1996,1996,2,2,1,1,1,0,0,1
"1816","MP Jarvis ",1987,1995,12,12,1,1,1,0,0,1
"1817","PW Jarvis ",1988,1993,16,16,1,1,1,0,0,1
"1818","Javed Qadeer ",1995,1995,1,1,1,1,0,1,0,1
"1819","SA Jayasinghe ",1979,1979,2,2,1,1,0,1,0,1
"1820","GSNFG Jayasuriya ",2015,2019,12,12,1,1,1,0,0,1
"1821","Jay Odedra ",2019,2020,3,3,1,1,1,0,0,1
"1822","S Jeganathan ",1983,1988,5,5,1,1,1,0,0,1
"1823","MR Johnson ",2004,2004,2,2,1,1,0,1,0,1
"1824","MBS Jonkman ",2006,2010,16,16,1,1,1,0,0,1
"1825","MMA Jonkman ",2007,2010,4,4,1,1,1,0,0,1
"1826","DI Joyce ",2006,2007,3,3,1,1,1,0,0,1
"1827","Jubair Hossain ",2014,2015,3,3,1,1,1,0,0,1
"1828","Kabir Khan ",1994,2000,10,9,1,1,1,0,0,1
"1829","Kamran Shazad ",2014,2015,4,4,1,1,1,0,0,1
"1830","TS Kamunhukamwe ",2018,2020,6,6,1,1,1,0,0,1
"1831","AR Kapoor ",1995,2000,17,17,1,1,1,0,0,1
"1832","M Karg ",2003,2003,3,3,1,1,0,1,0,1
"1833","SHU Karnain ",1984,1990,19,19,1,1,1,0,0,1
"1834","S Kaul ",2018,2018,3,3,1,1,1,0,0,1
"1835","RJ Kennedy ",1996,1996,7,7,1,1,1,0,0,1
"1836","JC Kent ",2002,2002,2,2,1,1,1,0,0,1
"1837","RB Kerr ",1985,1985,4,4,1,1,1,0,0,1
"1838","S Keshvani ",2009,2009,5,4,1,1,1,0,0,1
"1839","SP Khakurel ",2018,2020,5,5,1,0,0,0,1,1
"1840","Khalid Latif ",2008,2010,5,5,1,1,1,0,0,1
"1841","Khurram Nawaz ",2019,2019,3,3,1,1,1,0,0,1
"1842","GE Kidd ",2007,2008,6,5,1,1,1,0,0,1
"1843","J Kila ",2018,2019,6,6,1,1,1,0,0,1
"1844","VJ Kingma ",2014,2019,3,3,1,1,1,0,0,1
"1845","JF Kloppenburg ",2002,2003,6,6,1,1,1,0,0,1
"1846","BL Kotze ",2003,2003,5,5,1,1,1,0,0,1
"1847","GJP Kruger ",2006,2006,3,3,1,1,1,0,0,1
"1848","CKB Kulasekara ",2011,2012,4,4,1,1,1,0,0,1
"1849","M Labuschagne ",2020,2020,7,7,1,1,1,0,0,1
"1850","JPR Lamsam ",2004,2008,2,2,1,1,1,0,0,1
"1851","WM Lawry ",1971,1971,1,1,1,1,1,0,0,1
"1852","ML Lewis ",2005,2006,7,7,1,1,1,0,0,1
"1853","ACI Lock ",1996,1996,8,7,1,1,1,0,0,1
"1854","JL Louw ",2003,2003,1,1,1,1,1,0,0,1
"1855","JD Love ",1981,1981,3,3,1,1,1,0,0,1
"1856","SW Lubbers ",1996,1996,4,4,1,1,1,0,0,1
"1857","MJ Lumb ",2014,2014,3,3,1,1,1,0,0,1
"1858","AS Luseno ",2003,2010,10,10,1,1,1,0,0,1
"1859","MA Lynch ",1988,1988,3,3,1,1,1,0,0,1
"1860","RJ McCurdy ",1985,1985,11,11,1,1,1,0,0,1
"1861","PE McEwan ",1980,1985,17,17,1,1,1,0,0,1
"1862","AJ Mackay ",2001,2001,3,3,1,1,1,0,0,1
"1863","GD McKenzie ",1971,1971,1,1,1,1,1,0,0,1
"1864","DL Maddy ",1998,2000,8,8,1,1,1,0,0,1
"1865","W Madhevere ",2020,2020,3,3,1,1,1,0,0,1
"1866","Mafizur Rahman ",1997,1997,4,4,1,1,1,0,0,1
"1867","KA Maharaj ",2017,2020,7,7,1,1,1,0,0,1
"1868","Mahbubul Alam ",2009,2009,5,5,1,1,1,0,0,1
"1869","SI Mahmood ",2004,2009,26,26,1,1,1,0,0,1
"1870","GT Main ",2019,2019,1,1,1,1,1,0,0,1
"1871","DE Malcolm ",1990,1994,10,10,1,1,1,0,0,1
"1872","MF Malone ",1977,1982,10,10,1,1,1,0,0,1
"1873","Manzoor Akhtar ",1997,1998,7,7,1,1,1,0,0,1
"1874","PJ Martin ",1995,1998,20,20,1,1,1,0,0,1
"1875","RAL Massie ",1972,1972,3,3,1,1,1,0,0,1
"1876","EZ Matambanadzo ",1996,1997,7,7,1,1,1,0,0,1
"1877","Mazhar Hussain ",1994,1996,7,7,1,1,1,0,0,1
"1878","JA McCollum ",2019,2020,9,9,1,1,1,0,0,1
"1879","V Mehra ",1994,1996,6,6,1,1,1,0,0,1
"1880","KP Meiyappan ",2019,2020,4,4,1,1,1,0,0,1
"1881","KO Meth ",2006,2012,11,11,1,1,1,0,0,1
"1882","JP Millmow ",1990,1990,5,5,1,1,1,0,0,1
"1883","A Mithun ",2010,2011,5,5,1,1,1,0,0,1
"1884","Mohammad Boota ",2018,2019,9,9,1,0,0,0,1,1
"1885","Mohammad Hasnain ",2019,2019,5,5,1,1,1,0,0,1
"1886","Mohammad Ishaq ",1994,1996,5,5,1,1,1,0,0,1
"1887","Mohammad Salim ",2003,2003,1,1,1,1,0,1,0,1
"1888","Mohammad Sharif ",2001,2007,9,9,1,1,1,0,0,1
"1889","Mohammad Zahid ",1996,2002,11,11,1,1,1,0,0,1
"1890","D Mohammed ",2006,2008,7,7,1,1,1,0,0,1
"1891","Mosharraf Hossain ",2008,2016,5,5,1,1,1,0,0,1
"1892","TV Mufambisi ",2006,2007,6,6,1,1,0,1,0,1
"1893","SP Mukherjee ",1990,1991,3,3,1,1,1,0,0,1
"1894","J Mulder ",2017,2017,4,4,1,1,1,0,0,1
"1895","CT Mumba ",2016,2020,5,5,1,1,1,0,0,1
"1896","N M'shangwe ",2011,2014,6,6,1,1,1,0,0,1
"1897","DT Mutendera ",1999,2001,9,9,1,1,1,0,0,1
"1898","G Mylvaganam ",1996,1996,3,3,1,1,1,0,0,1
"1899","Naeemuddin Aslam ",2004,2004,2,2,1,1,1,0,0,1
"1900","Naeem Ahmed ",1978,1978,1,1,1,1,1,0,0,1
"1901","Najeeb Amar ",2004,2008,4,4,1,1,1,0,0,1
"1902","Naseem Khushi ",2020,2020,6,6,1,1,1,0,0,1
"1903","BP Nash ",2008,2009,9,8,1,1,1,0,0,1
"1904","SV Nayak ",1981,1982,4,4,1,1,1,0,0,1
"1905","Nazimuddin ",2008,2012,11,11,1,1,1,0,0,1
"1906","Neeyamur Rashid ",1999,1999,2,2,1,1,1,0,0,1
"1907","A Neill ",2019,2019,1,1,1,1,1,0,0,1
"1908","R Ngarava ",2017,2018,9,9,1,1,1,0,0,1
"1909","Noor-ul-Haq ",2010,2010,2,2,1,1,1,0,0,1
"1910","MJ North ",2009,2009,2,2,1,1,1,0,0,1
"1911","GH O'Brien ",2006,2008,9,9,1,1,1,0,0,1
"1912","IE O'Brien ",2008,2009,10,10,1,1,1,0,0,1
"1913","NM Odhiambo ",2010,2013,8,8,1,1,1,0,0,1
"1914","NV Ojha ",2010,2010,1,1,1,0,0,0,1,1
"1915","LN Oluoch ",2011,2011,2,2,1,1,1,0,0,1
"1916","G Onions ",2009,2009,4,4,1,1,1,0,0,1
"1917","Pankaj Singh ",2010,2010,1,1,1,1,1,0,0,1
"1918","MHW Papps ",2004,2005,6,6,1,1,1,0,0,1
"1919","JS Paris ",2016,2016,2,2,1,1,1,0,0,1
"1920","NM Parker ",1976,1976,1,1,1,1,1,0,0,1
"1921","AK Patel ",1984,1985,8,7,1,1,1,0,0,1
"1922","BP Patel ",1974,1979,10,10,1,1,1,0,0,1
"1923","NK Patel ",2019,2020,8,8,1,1,1,0,0,1
"1924","J Patraj ",2007,2007,2,2,1,1,1,0,0,1
"1925","SG Peall ",1992,1996,21,20,1,1,1,0,0,1
"1926","AJ Penn ",1997,2001,5,5,1,1,1,0,0,1
"1927","AK Perera ",2013,2019,6,6,1,1,1,0,0,1
"1928","PARP Perera ",2019,2019,2,2,1,1,1,0,0,1
"1929","V Permaul ",2012,2017,7,7,1,1,1,0,0,1
"1930","AR Pitcher ",2006,2007,4,4,1,1,1,0,0,1
"1931","V Pollard ",1973,1974,3,3,1,1,1,0,0,1
"1932","RH Poonawala ",1994,1994,2,2,1,1,1,0,0,1
"1933","GD Porter ",1979,1979,2,2,1,1,1,0,0,1
"1934","KTGD Prasad ",2006,2015,24,24,1,1,1,0,0,1
"1935","AG Puttick ",2005,2005,1,1,1,1,1,0,0,1
"1936","Qadeer Ahmed ",2015,2019,11,11,1,1,1,0,0,1
"1937","Rahat Ali ",2012,2016,14,14,1,1,1,0,0,1
"1938","P Raho ",2014,2014,1,1,1,1,1,0,0,1
"1939","LN Rajbanshi ",2019,2020,4,4,1,1,1,0,0,1
"1940","CAK Rajitha ",2018,2019,9,9,1,1,1,0,0,1
"1941","SK Ranasinghe ",1986,1986,4,4,1,1,1,0,0,1
"1942","D Ranatunga ",1990,1990,4,4,1,1,1,0,0,1
"1943","U Ranchod ",1992,1993,3,3,1,1,1,0,0,1
"1944","Raqibul Hasan ",1986,1986,2,2,1,1,1,0,0,1
"1945","JB Reva ",2016,2018,9,9,1,1,1,0,0,1
"1946","ACL Richards ",2007,2007,1,1,1,1,1,0,0,1
"1947","MH Richardson ",2002,2002,4,4,1,1,1,0,0,1
"1948","Rizwan Ahmed ",2008,2008,1,1,1,1,1,0,0,1
"1949","ADG Roberts ",1976,1976,1,1,1,1,1,0,0,1
"1950","RJ Robinson ",2007,2009,3,3,1,1,1,0,0,1
"1951","LN Roche ",2018,2018,3,3,1,1,1,0,0,1
"1952","Rokhan Barakzai ",2015,2015,1,1,1,1,1,0,0,1
"1953","LC Romero ",2004,2004,2,2,1,1,1,0,0,1
"1954","BC Rose ",1977,1977,2,2,1,1,1,0,0,1
"1955","MW Rushmere ",1992,1992,4,4,1,1,1,0,0,1
"1956","Saadat Ali ",1984,1984,8,8,1,1,1,0,0,1
"1957","Saeed-al-Saffar ",1996,1996,1,1,1,1,1,0,0,1
"1958","Sajid Ali ",1984,1997,13,13,1,1,1,0,0,1
"1959","Saleem Altaf ",1973,1978,6,6,1,1,1,0,0,1
"1960","IDK Salisbury ",1993,1994,4,4,1,1,1,0,0,1
"1961","G Salmond ",1999,1999,5,5,1,1,1,0,0,1
"1962","JA Samarasekera ",1994,1996,7,7,1,1,1,0,0,1
"1963","S Samarawickrama ",2017,2019,7,7,1,1,1,0,0,1
"1964","Samiur Rahman ",1986,1986,2,2,1,1,1,0,0,1
"1965","RG Samuels ",1996,1997,8,8,1,1,1,0,0,1
"1966","KT Sandher ",2006,2007,15,15,1,1,1,0,0,1
"1967","BB Seebaran ",2003,2003,4,4,1,1,1,0,0,1
"1968","CS Serjeant ",1977,1978,3,3,1,1,1,0,0,1
"1969","RK Sethi ",1975,1975,3,3,1,1,1,0,0,1
"1970","Shadab Kabir ",1996,1996,3,3,1,1,1,0,0,1
"1971","Shafiq Ahmed ",1977,1978,3,3,1,1,1,0,0,1
"1972","KD Shah ",2014,2018,10,10,1,1,1,0,0,1
"1973","Shahid Mahboob ",1982,1984,10,10,1,1,1,0,0,1
"1974","Shan Masood ",2019,2019,5,5,1,1,1,0,0,1
"1975","R Sharma ",2004,2004,2,2,1,1,1,0,0,1
"1976","R Sharma ",2011,2012,4,4,1,1,1,0,0,1
"1977","B Shikongo ",2020,2020,1,1,1,1,1,0,0,1
"1978","LR Shukla ",1999,1999,3,3,1,1,1,0,0,1
"1979","K Shuttleworth ",1971,1971,1,1,1,1,1,0,0,1
"1980","PM Siddle ",2009,2019,20,19,1,1,1,0,0,1
"1981","RW Sims ",2002,2003,3,3,1,1,1,0,0,1
"1982","L Sipamla ",2020,2020,4,3,1,1,1,0,0,1
"1983","MA Small ",1984,1984,2,2,1,1,1,0,0,1
"1984","MJ Smith ",1973,1974,5,5,1,1,1,0,0,1
"1985","NMK Smith ",1996,1996,7,7,1,1,1,0,0,1
"1986","JA Snow ",1971,1975,9,8,1,1,1,0,0,1
"1987","GS Sobers ",1973,1973,1,1,1,1,1,0,0,1
"1988","Sohail Fazal ",1989,1989,2,2,1,1,1,0,0,1
"1989","Sompal Kami ",2018,2019,6,6,1,1,1,0,0,1
"1990","D Soraine ",2006,2012,4,4,1,1,1,0,0,1
"1991","BB Sran ",2016,2016,6,6,1,1,1,0,0,1
"1992","L Sreekumar ",2015,2016,4,4,1,1,1,0,0,1
"1993","S Sriram ",2000,2004,8,8,1,1,1,0,0,1
"1994","KR Stackpole ",1971,1974,6,6,1,1,1,0,0,1
"1995","JH Stander ",2009,2012,5,5,1,1,1,0,0,1
"1996","B Stanlake ",2017,2019,7,7,1,1,1,0,0,1
"1997","LW Stokkers ",2008,2008,1,1,1,1,1,0,0,1
"1998","LW Stott ",1979,1979,1,1,1,1,1,0,0,1
"1999","CEL Stuart ",2001,2001,5,5,1,1,1,0,0,1
"2000","ML Su'a ",1992,1995,12,12,1,1,1,0,0,1
"2001","R Sudhakar Rao ",1976,1976,1,1,1,1,1,0,0,1
"2002","Syed Maqsood ",2004,2004,2,2,1,1,1,0,0,1
"2003","Taijul Islam ",2014,2020,9,9,1,1,1,0,0,1
"2004","Talha Jubair ",2002,2003,6,6,1,1,1,0,0,1
"2005","Tanbir Hayder ",2016,2016,2,2,1,1,1,0,0,1
"2006","Tanvir Ahmed ",2011,2011,2,2,1,1,1,0,0,1
"2007","BR Taylor ",1973,1973,2,2,1,1,1,0,0,1
"2008","GJ Thompson ",2008,2008,3,3,1,1,1,0,0,1
"2009","FJ Titmus ",1975,1975,2,2,1,1,1,0,0,1
"2010","RW Tolchard ",1979,1979,1,1,1,1,0,1,0,1
"2011","CP Tremain ",2016,2016,4,4,1,1,1,0,0,1
"2012","JO Troughton ",2003,2003,6,5,1,1,1,0,0,1
"2013","AJ Tudor ",2002,2002,3,3,1,1,1,0,0,1
"2014","S Tyagi ",2009,2010,4,4,1,1,1,0,0,1
"2015","AJ Tye ",2018,2018,7,7,1,1,1,0,0,1
"2016","SD Udal ",1994,2005,11,11,1,1,1,0,0,1
"2017","Umair Ali ",2015,2015,2,2,1,1,1,0,0,1
"2018","Usman Salahuddin ",2011,2011,2,2,1,1,1,0,0,1
"2019","JN Valentine ",1979,1979,3,3,1,1,1,0,0,1
"2020","A van der Merwe ",2010,2011,9,9,1,1,1,0,0,1
"2021","VB van Jaarsveld ",2009,2009,2,2,1,1,1,0,0,1
"2022","S Vesawkar ",2018,2020,2,2,1,1,1,0,0,1
"2023","TP Visee ",2019,2019,2,2,1,1,1,0,0,1
"2024","AL Wadekar ",1974,1974,2,2,1,1,1,0,0,1
"2025","I Wardlaw ",2013,2015,22,21,1,1,1,0,0,1
"2026","Washington Sundar ",2017,2017,1,1,1,1,1,0,0,1
"2027","SR Welsh ",2006,2008,3,3,1,1,1,0,0,1
"2028","BA Westdijk ",2011,2011,4,4,1,1,1,0,0,1
"2029","AG Wharf ",2004,2005,13,13,1,1,1,0,0,1
"2030","BM Wheeler ",2015,2015,6,6,1,1,1,0,0,1
"2031","JJ Whitaker ",1987,1987,2,2,1,1,1,0,0,1
"2032","DJ White ",1990,1990,3,3,1,1,1,0,0,1
"2033","P Wilson ",1997,1998,11,11,1,1,1,0,0,1
"2034","WA Wisneski ",2000,2000,3,3,1,1,1,0,0,1
"2035","DJ Worrall ",2016,2016,3,3,1,1,1,0,0,1
"2036","CM Wright ",2006,2009,20,20,1,1,1,0,0,1
"2037","M Yachad ",1991,1991,1,1,1,1,1,0,0,1
"2038","J Yadav ",2016,2016,1,1,1,1,1,0,0,1
"2039","NS Yadav ",1986,1987,7,7,1,1,1,0,0,1
"2040","HN Ya France ",2019,2020,7,7,1,1,1,0,0,1
"2041","B Yardley ",1978,1983,7,5,1,1,1,0,0,1
"2042","Younis Ahmed ",1987,1987,2,2,1,1,1,0,0,1
"2043","Zafar Iqbal ",1995,1995,8,8,1,1,1,0,0,1
"2044","Zahid Hussain ",2011,2011,2,2,1,1,1,0,0,1
"2045","Sultan Zarawani ",1994,1996,7,7,1,1,1,0,0,1
"2046","AK Zesers ",1987,1987,2,2,1,1,1,0,0,1
"2047","C Zhuwao ",2008,2018,9,9,1,1,1,0,0,1
"2048","K Zondo ",2018,2018,5,5,1,1,1,0,0,1
"2049","Zulfiqar Ali ",1975,1975,3,3,1,1,1,0,0,1
"2050","ME Sanuth ",2020,2020,3,3,0,0,0,0,0,0
"2051","Aamer Hanif ",1993,1995,5,5,0,0,0,0,0,0
"2052","Aamer Nazir ",1993,1995,9,9,0,0,0,0,0,0
"2053","Aamer Yamin ",2015,2018,4,4,0,0,0,0,0,0
"2054","SA Abbott ",2014,2014,1,1,0,0,0,0,0,0
"2055","Abdul Rehman ",2004,2004,1,1,0,0,0,0,0,0
"2056","S Abid Ali ",1974,1975,5,5,0,0,0,0,0,0
"2057","Abu Jayed ",2019,2019,2,2,0,0,0,0,0,0
"2058","Afif Hossain ",2020,2020,1,1,0,0,0,0,0,0
"2059","FS Ahangama ",1985,1985,1,1,0,0,0,0,0,0
"2060","Ahmed Kamal ",1999,1999,1,1,0,0,0,0,0,0
"2061","Ahmed Shah ",2009,2009,1,1,0,0,0,0,0,0
"2062","KS Airee ",2020,2020,1,1,0,0,0,0,0,0
"2063","Akhtar Sarfraz ",1997,1998,4,4,0,0,0,0,0,0
"2064","Alawi Shukri ",2008,2008,1,1,0,0,0,0,0,0
"2065","GW Aldridge ",2011,2011,2,2,0,0,0,0,0,0
"2066","RP Alexander ",2004,2004,2,2,0,0,0,0,0,0
"2067","Ali Asad ",2004,2004,2,2,0,0,0,0,0,0
"2068","Ali Khan ",2019,2019,1,1,0,0,0,0,0,0
"2069","KN Amalean ",1986,1988,8,8,0,0,0,0,0,0
"2070","Aman Ali ",2008,2008,1,1,0,0,0,0,0,0
"2071","Aminul Islam jnr ",1999,1999,1,1,0,0,0,0,0,0
"2072","J Angel ",1994,1995,3,3,0,0,0,0,0,0
"2073","Anisur Rahman ",1995,1998,2,2,0,0,0,0,0,0
"2074","ZS Ansari ",2015,2015,1,1,0,0,0,0,0,0
"2075","HAG Anthony ",1995,1995,3,3,0,0,0,0,0,0
"2076","Anwar Hossain Monir ",2002,2002,1,1,0,0,0,0,0,0
"2077","Anwar Hossain ",2002,2002,1,1,0,0,0,0,0,0
"2078","GJAF Aponso ",1996,1996,5,5,0,0,0,0,0,0
"2079","MA Aponso ",2016,2018,9,9,0,0,0,0,0,0
"2080","Ariful Haque ",2018,2018,1,1,0,0,0,0,0,0
"2081","Arshad Pervez ",1978,1978,2,2,0,0,0,0,0,0
"2082","B Arun ",1986,1987,4,4,0,0,0,0,0,0
"2083","Asad Ali ",2013,2013,4,4,0,0,0,0,0,0
"2084","Asghar Ali ",2004,2004,2,2,0,0,0,0,0,0
"2085","Ashfaq Ahmed ",1994,1994,3,3,0,0,0,0,0,0
"2086","Asif Iqbal ",2015,2015,1,1,0,0,0,0,0,0
"2087","Asif Mahmood ",1998,1998,2,2,0,0,0,0,0,0
"2088","Asim Butt ",1999,1999,5,5,0,0,0,0,0,0
"2089","Asim Saeed ",2004,2004,2,2,0,0,0,0,0,0
"2090","SK Atai ",2019,2019,2,2,0,0,0,0,0,0
"2091","Ata-ur-Rehman ",1992,1996,30,30,0,0,0,0,0,0
"2092","ID Austin ",1998,1999,9,9,0,0,0,0,0,0
"2093","RA Austin ",1978,1978,1,1,0,0,0,0,0,0
"2094","Azmat Rana ",1978,1978,2,2,0,0,0,0,0,0
"2095","MD Bailey ",1998,1998,1,1,0,0,0,0,0,0
"2096","PJ Bakker ",1996,1996,5,5,0,0,0,0,0,0
"2097","S Baksh ",1979,1979,1,1,0,0,0,0,0,0
"2098","KMC Bandara ",2016,2016,1,1,0,0,0,0,0,0
"2099","MRCN Bandaratilleke ",1998,1998,3,3,0,0,0,0,0,0
"2100","OAC Banks ",2003,2005,5,5,0,0,0,0,0,0
"2101","T Banton ",2020,2020,3,3,0,0,0,0,0,0
"2102","KJ Barnett ",1988,1988,1,1,0,0,0,0,0,0
"2103","DM Basden ",2007,2007,2,2,0,0,0,0,0,0
"2104","GR Beard ",1981,1981,2,2,0,0,0,0,0,0
"2105","RR Beaton ",2017,2017,2,2,0,0,0,0,0,0
"2106","JE Benjamin ",1994,1995,2,2,0,0,0,0,0,0
"2107","MR Benson ",1986,1986,1,1,0,0,0,0,0,0
"2108","A Bhandari ",2000,2004,2,2,0,0,0,0,0,0
"2109","LS Bhandari ",2018,2018,1,1,0,0,0,0,0,0
"2110","M Bhanuka ",2019,2019,1,1,0,0,0,0,0,0
"2111","S Bhari ",2020,2020,4,4,0,0,0,0,0,0
"2112","Bhupinder Singh snr ",1994,1994,2,2,0,0,0,0,0,0
"2113","MI Black ",2001,2001,5,5,0,0,0,0,0,0
"2114","DL Blake ",2004,2004,1,1,0,0,0,0,0,0
"2115","G Blakeney ",2009,2009,2,2,0,0,0,0,0,0
"2116","A Bohara ",2020,2020,2,2,0,0,0,0,0,0
"2117","SG Borthwick ",2011,2011,2,2,0,0,0,0,0,0
"2118","T Bosch ",1992,1992,2,2,0,0,0,0,0,0
"2119","GK Bose ",1974,1974,1,1,0,0,0,0,0,0
"2120","KD Boyce ",1973,1975,8,8,0,0,0,0,0,0
"2121","BP Bracewell ",1978,1978,1,1,0,0,0,0,0,0
"2122","GA Briant ",1993,1993,5,5,0,0,0,0,0,0
"2123","DR Briggs ",2012,2012,1,1,0,0,0,0,0,0
"2124","SA Britton ",2009,2009,1,1,0,0,0,0,0,0
"2125","D Brown ",2001,2002,3,3,0,0,0,0,0,0
"2126","BS Browne ",1994,1994,4,4,0,0,0,0,0,0
"2127","GK Bruk-Jackson ",1993,1993,1,1,0,0,0,0,0,0
"2128","DE Budge ",2018,2019,3,3,0,0,0,0,0,0
"2129","AJ Burger ",2003,2003,6,6,0,0,0,0,0,0
"2130","AR Butcher ",1980,1980,1,1,0,0,0,0,0,0
"2131","RO Butcher ",1980,1981,3,3,0,0,0,0,0,0
"2132","DK Butler ",2005,2006,5,5,0,0,0,0,0,0
"2133","RG Callender ",1979,1979,2,2,0,0,0,0,0,0
"2134","JD Campbell ",2019,2019,6,5,0,0,0,0,0,0
"2135","PE Cantrell ",1996,1996,5,5,0,0,0,0,0,0
"2136","PH Carlson ",1979,1979,4,3,0,0,0,0,0,0
"2137","NM Carter ",2013,2013,3,3,0,0,0,0,0,0
"2138","DL Chahar ",2018,2019,3,3,0,0,0,0,0,0
"2139","SJ Chalmers ",2009,2009,2,2,0,0,0,0,0,0
"2140","BS Chandrasekhar ",1976,1976,1,1,0,0,0,0,0,0
"2141","VB Chandrasekhar ",1988,1990,7,7,0,0,0,0,0,0
"2142","CJD Chappell ",1979,1979,3,3,0,0,0,0,0,0
"2143","G Chapple ",2006,2006,1,1,0,0,0,0,0,0
"2144","M Cheruparambil ",2004,2004,2,2,0,0,0,0,0,0
"2145","MT Chinouya ",2013,2013,2,2,0,0,0,0,0,0
"2146","K Christie ",2016,2016,1,1,0,0,0,0,0,0
"2147","WM Clark ",1978,1978,2,2,0,0,0,0,0,0
"2148","A Codrington ",2003,2007,9,9,0,0,0,0,0,0
"2149","DJ Colley ",1972,1972,1,1,0,0,0,0,0,0
"2150","BE Congdon ",1973,1978,11,11,0,0,0,0,0,0
"2151","AN Connolly ",1971,1971,1,1,0,0,0,0,0,0
"2152","GA Cope ",1977,1978,2,2,0,0,0,0,0,0
"2153","MJ Cosgrove ",2006,2006,3,3,0,0,0,0,0,0
"2154","CS Cowdrey ",1985,1985,3,3,0,0,0,0,0,0
"2155","MC Cowdrey ",1971,1971,1,1,0,0,0,0,0,0
"2156","RT Crandon ",2009,2009,1,1,0,0,0,0,0,0
"2157","FS Crockwell ",2009,2009,2,2,0,0,0,0,0,0
"2158","SM Curran ",2018,2020,4,4,0,0,0,0,0,0
"2159","SS Das ",2001,2002,4,4,0,0,0,0,0,0
"2160","NA David ",1997,1997,4,4,0,0,0,0,0,0
"2161","RR David ",2008,2010,4,4,0,0,0,0,0,0
"2162","H Davids ",2013,2013,2,1,0,0,0,0,0,0
"2163","SG Davies ",1996,1996,4,4,0,0,0,0,0,0
"2164","IC Davis ",1974,1977,3,3,0,0,0,0,0,0
"2165","Dawlat Ahmadzai ",2009,2010,3,3,0,0,0,0,0,0
"2166","JJ Dawood ",2009,2010,2,1,0,0,0,0,0,0
"2167","LA Dawson ",2016,2018,3,2,0,0,0,0,0,0
"2168","NA de Groot ",2003,2003,6,6,0,0,0,0,0,0
"2169","M de Lange ",2012,2016,4,4,0,0,0,0,0,0
"2170","GJ Delany ",2020,2020,2,2,0,0,0,0,0,0
"2171","FA Dennis ",1979,1979,3,3,0,0,0,0,0,0
"2172","GN de Silva ",1983,1985,4,4,0,0,0,0,0,0
"2173","JI de Villiers ",2020,2020,2,2,0,0,0,0,0,0
"2174","P Dharmani ",1996,1996,1,1,0,0,0,0,0,0
"2175","R Dhawan ",2016,2016,3,3,0,0,0,0,0,0
"2176","HS Dhillon ",2006,2006,2,2,0,0,0,0,0,0
"2177","WP Diepeveen ",2011,2011,1,1,0,0,0,0,0,0
"2178","Dolar Mahmud ",2008,2009,7,7,0,0,0,0,0,0
"2179","BR Dorey ",2006,2006,4,4,0,0,0,0,0,0
"2180","CRM Douglas ",2008,2008,2,2,0,0,0,0,0,0
"2181","SO Dowrich ",2019,2019,1,1,0,0,0,0,0,0
"2182","S Dube ",2019,2019,1,1,0,0,0,0,0,0
"2183","BM Duckett ",2016,2016,3,3,0,0,0,0,0,0
"2184","DM Dupavillon ",2020,2020,1,1,0,0,0,0,0,0
"2185","N Dutta ",2013,2013,1,1,0,0,0,0,0,0
"2186","PS Eaglestone ",2008,2008,1,1,0,0,0,0,0,0
"2187","JH Edrich ",1971,1975,7,7,0,0,0,0,0,0
"2188","R Edwards ",1972,1975,9,9,0,0,0,0,0,0
"2189","WJ Edwards ",1975,1975,1,1,0,0,0,0,0,0
"2190","Ehsanul Haque ",2002,2003,6,6,0,0,0,0,0,0
"2191","Ehsan Adil ",2013,2015,6,6,0,0,0,0,0,0
"2192","Elias Sunny ",2011,2012,4,4,0,0,0,0,0,0
"2193","MTG Elliott ",1997,1997,1,1,0,0,0,0,0,0
"2194","Fahad Alhashmi ",2008,2015,5,5,0,0,0,0,0,0
"2195","Fahad Nawaz ",2019,2019,2,2,0,0,0,0,0,0
"2196","Faisal Athar ",2003,2003,1,1,0,0,0,0,0,0
"2197","Fawad Ahmed ",2013,2013,3,3,0,0,0,0,0,0
"2198","Fayyaz Ahmed ",2014,2016,3,3,0,0,0,0,0,0
"2199","FY Fazal ",2016,2016,1,1,0,0,0,0,0,0
"2200","Fazl-e-Akbar ",1998,2001,2,2,0,0,0,0,0,0
"2201","N Fernandes ",2008,2008,1,1,0,0,0,0,0,0
"2202","AM Fernando ",2017,2017,1,1,0,0,0,0,0,0
"2203","ER Fernando ",1975,1975,3,3,0,0,0,0,0,0
"2204","ERNS Fernando ",1983,1983,7,7,0,0,0,0,0,0
"2205","MVT Fernando ",2017,2019,8,8,0,0,0,0,0,0
"2206","TL Fernando ",1989,1989,1,1,0,0,0,0,0,0
"2207","UNK Fernando ",1994,1994,2,2,0,0,0,0,0,0
"2208","R Flannigan ",2010,2010,1,1,0,0,0,0,0,0
"2209","DAG Fletcher ",1983,1983,6,6,0,0,0,0,0,0
"2210","MLC Foster ",1973,1973,2,2,0,0,0,0,0,0
"2211","TJ Franklin ",1983,1988,3,3,0,0,0,0,0,0
"2212","Frasat Ali ",1975,1975,3,3,0,0,0,0,0,0
"2213","IS Gallage ",1999,2001,3,3,0,0,0,0,0,0
"2214","DJ Gandhi ",1999,2000,3,3,0,0,0,0,0,0
"2215","D Ganesh ",1997,1997,1,1,0,0,0,0,0,0
"2216","LV Garrick ",2001,2001,3,3,0,0,0,0,0,0
"2217","WT Gavera ",2014,2017,4,4,0,0,0,0,0,0
"2218","RS Ghai ",1984,1986,6,6,0,0,0,0,0,0
"2219","Gholam Nousher ",1986,1990,9,9,0,0,0,0,0,0
"2220","Ghulam Ali ",1993,1995,3,3,0,0,0,0,0,0
"2221","T Gibbons ",2006,2006,2,2,0,0,0,0,0,0
"2222","LR Gibbs ",1973,1975,3,3,0,0,0,0,0,0
"2223","PG Gillespie ",2006,2007,5,5,0,0,0,0,0,0
"2224","Golam Faruq ",1986,1990,5,5,0,0,0,0,0,0
"2225","MS Gony ",2008,2008,2,2,0,0,0,0,0,0
"2226","Y Goonasekera ",1983,1983,3,3,0,0,0,0,0,0
"2227","JOA Gordon ",2012,2014,5,5,0,0,0,0,0,0
"2228","EL Gouka ",1996,1996,3,3,0,0,0,0,0,0
"2229","VD Grandia ",2002,2002,1,1,0,0,0,0,0,0
"2230","AE Greenidge ",1978,1978,1,1,0,0,0,0,0,0
"2231","RD Gudhka ",2011,2011,2,2,0,0,0,0,0,0
"2232","FRMD Gunatilleke ",1979,1979,1,1,0,0,0,0,0,0
"2233","AAW Gunawardena ",1994,1994,1,1,0,0,0,0,0,0
"2234","SK Gupta ",1996,2001,10,10,0,0,0,0,0,0
"2235","Gurdeep Singh ",2013,2013,1,1,0,0,0,0,0,0
"2236","Haafiz Shahid ",1988,1988,3,3,0,0,0,0,0,0
"2237","BG Hadlee ",1975,1975,2,2,0,0,0,0,0,0
"2238","OJ Hairs ",2010,2010,5,5,0,0,0,0,0,0
"2239","JD Hall ",2010,2010,3,3,0,0,0,0,0,0
"2240","LJ Hamilton ",2005,2005,2,2,0,0,0,0,0,0
"2241","JR Hammond ",1972,1972,1,1,0,0,0,0,0,0
"2242","JH Hampshire ",1971,1972,3,3,0,0,0,0,0,0
"2243","Hamza Tahir ",2019,2019,6,6,0,0,0,0,0,0
"2244","Harilal Shah ",1975,1975,3,3,0,0,0,0,0,0
"2245","RT Hart ",1985,1985,1,1,0,0,0,0,0,0
"2246","Harunur Rashid ",1988,1988,2,2,0,0,0,0,0,0
"2247","SM Harwood ",2009,2009,1,1,0,0,0,0,0,0
"2248","MJ Haslam ",1992,1992,1,1,0,0,0,0,0,0
"2249","Hasti Gul ",2009,2009,2,2,0,0,0,0,0,0
"2250","FC Hayes ",1973,1975,6,5,0,0,0,0,0,0
"2251","RL Hayes ",1995,1995,1,1,0,0,0,0,0,0
"2252","RGA Headley ",1973,1973,1,1,0,0,0,0,0,0
"2253","SD Heazlett ",2017,2017,1,1,0,0,0,0,0,0
"2254","R Hekure ",2019,2019,1,1,0,0,0,0,0,0
"2255","CW Henderson ",2001,2001,4,4,0,0,0,0,0,0
"2256","CC Henry ",1979,1979,2,2,0,0,0,0,0,0
"2257","H Hiri ",2016,2019,7,7,0,0,0,0,0,0
"2258","VR Hogg ",1983,1983,2,2,0,0,0,0,0,0
"2259","RG Holland ",1985,1985,2,2,0,0,0,0,0,0
"2260","DAW Hollis ",2008,2008,1,1,0,0,0,0,0,0
"2261","PA Horne ",1987,1987,4,4,0,0,0,0,0,0
"2262","Hussain Talat ",2019,2019,1,1,0,0,0,0,0,0
"2263","Ilyas Gull ",2004,2004,2,2,0,0,0,0,0,0
"2264","Intikhab Alam ",1973,1976,4,4,0,0,0,0,0,0
"2265","Iqbal Sikander ",1992,1992,4,4,0,0,0,0,0,0
"2266","Irfan Fazil ",2000,2000,1,1,0,0,0,0,0,0
"2267","Irfan Sajid ",2014,2014,1,1,0,0,0,0,0,0
"2268","Ishtiaq Muhammad ",2016,2016,1,1,0,0,0,0,0,0
"2269","W Jaffer ",2006,2006,2,2,0,0,0,0,0,0
"2270","Jahangir Alam Talukdar ",1990,1990,2,2,0,0,0,0,0,0
"2271","JA Jameson ",1973,1975,3,3,0,0,0,0,0,0
"2272","Jasdeep Singh ",2019,2019,4,4,0,0,0,0,0,0
"2273","Jawahir Shah ",1975,1975,3,3,0,0,0,0,0,0
"2274","PS Jayaprakashdaran ",2005,2005,1,1,0,0,0,0,0,0
"2275","RSA Jayasekera ",1982,1982,2,2,0,0,0,0,0,0
"2276","NGRP Jayasuriya ",2018,2018,2,2,0,0,0,0,0,0
"2277","TJ Jenner ",1975,1975,1,1,0,0,0,0,0,0
"2278","KCB Jeremy ",2000,2001,6,6,0,0,0,0,0,0
"2279","K Jethi ",2008,2008,3,3,0,0,0,0,0,0
"2280","HR Johnson ",2004,2004,2,2,0,0,0,0,0,0
"2281","RL Johnson ",2003,2003,10,9,0,0,0,0,0,0
"2282","RA Jones ",2003,2003,5,5,0,0,0,0,0,0
"2283","SP Jones ",2004,2005,8,8,0,0,0,0,0,0
"2284","C Jonker ",2018,2018,2,2,0,0,0,0,0,0
"2285","S Jora ",2019,2019,1,1,0,0,0,0,0,0
"2286","D Joseph ",2003,2003,4,4,0,0,0,0,0,0
"2287","Junaid Siddique ",2019,2020,6,6,0,0,0,0,0,0
"2288","Junaid Zia ",2003,2003,4,4,0,0,0,0,0,0
"2289","R Kaia ",2015,2015,1,1,0,0,0,0,0,0
"2290","AV Kale ",2003,2003,1,1,0,0,0,0,0,0
"2291","LWS Kaluperuma ",1975,1982,4,4,0,0,0,0,0,0
"2292","Kamran Hussain ",2008,2008,2,2,0,0,0,0,0,0
"2293","K Kamyuka ",2013,2013,2,2,0,0,0,0,0,0
"2294","AL Kandappah ",2007,2007,2,2,0,0,0,0,0,0
"2295","Karan KC ",2018,2020,9,9,0,0,0,0,0,0
"2296","Karim Janat ",2017,2017,1,1,0,0,0,0,0,0
"2297","Kashif Raza ",2001,2001,1,1,0,0,0,0,0,0
"2298","F Kasteni ",2007,2007,3,3,0,0,0,0,0,0
"2299","E Katchay ",2008,2009,5,5,0,0,0,0,0,0
"2300","PHT Kaushal ",2015,2015,1,1,0,0,0,0,0,0
"2301","RWT Key ",2003,2004,5,5,0,0,0,0,0,0
"2302","Khalid Khan ",2004,2004,2,2,0,0,0,0,0,0
"2303","Khaliq Dad ",2009,2010,6,6,0,0,0,0,0,0
"2304","GK Khoda ",1998,1998,2,2,0,0,0,0,0,0
"2305","JP Kotze ",2019,2020,8,8,0,0,0,0,0,0
"2306","CK Kruger ",2008,2008,2,2,0,0,0,0,0,0
"2307","SC Kuggeleijn ",2017,2017,2,2,0,0,0,0,0,0
"2308","Kushal Malla ",2020,2020,3,3,0,0,0,0,0,0
"2309","MKGCP Lakshitha ",2002,2003,7,7,0,0,0,0,0,0
"2310","AV Lalcheta ",2019,2019,2,2,0,0,0,0,0,0
"2311","SB Lama ",2004,2004,1,1,0,0,0,0,0,0
"2312","GA Lamb ",2010,2011,15,15,0,0,0,0,0,0
"2313","CB Lambert ",1990,2004,12,12,0,0,0,0,0,0
"2314","TJ Laughlin ",1978,1979,6,6,0,0,0,0,0,0
"2315","DV Lawrence ",1991,1991,1,1,0,0,0,0,0,0
"2316","JJC Lawson ",2001,2005,13,12,0,0,0,0,0,0
"2317","J Lewis ",2005,2007,13,13,0,0,0,0,0,0
"2318","Liaqat Ali ",1977,1978,3,3,0,0,0,0,0,0
"2319","GFJ Liebenberg ",1995,1998,4,4,0,0,0,0,0,0
"2320","JB Little ",2019,2019,4,4,0,0,0,0,0,0
"2321","TA Lloyd ",1984,1984,3,3,0,0,0,0,0,0
"2322","CH Lonsdale ",2007,2007,1,1,0,0,0,0,0,0
"2323","AGR Loudon ",2006,2006,1,1,0,0,0,0,0,0
"2324","J Louw ",2008,2008,3,3,0,0,0,0,0,0
"2325","MB Loye ",2007,2007,7,7,0,0,0,0,0,0
"2326","BW Luckhurst ",1975,1975,3,3,0,0,0,0,0,0
"2327","C McAuslan ",2017,2017,2,2,0,0,0,0,0,0
"2328","OC McCoy ",2018,2018,2,2,0,0,0,0,0,0
"2329","JA Maclean ",1979,1979,2,1,0,0,0,0,0,0
"2330","H McLeod ",1975,1975,2,2,0,0,0,0,0,0
"2331","NJ MacRae ",2006,2006,2,2,0,0,0,0,0,0
"2332","DSK Madushanka ",2018,2018,1,1,0,0,0,0,0,0
"2333","LD Madushanka ",2017,2017,4,4,0,0,0,0,0,0
"2334","Mahbubur Rahman ",1999,1999,1,1,0,0,0,0,0,0
"2335","S Mahmood ",2020,2020,1,1,0,0,0,0,0,0
"2336","Mahmood Hamid ",1995,1995,1,1,0,0,0,0,0,0
"2337","DJ Malan ",2019,2019,1,1,0,0,0,0,0,0
"2338","AV Mankad ",1974,1974,1,1,0,0,0,0,0,0
"2339","Mansoor Amjad ",2008,2008,1,1,0,0,0,0,0,0
"2340","Mansoor Rana ",1990,1990,2,2,0,0,0,0,0,0
"2341","Maqsood Rana ",1990,1990,1,1,0,0,0,0,0,0
"2342","CA Marshall ",1979,1979,2,2,0,0,0,0,0,0
"2343","JAH Marshall ",2005,2008,10,10,0,0,0,0,0,0
"2344","GC Martin ",1994,1995,5,5,0,0,0,0,0,0
"2345","Masood Iqbal ",1984,1984,1,1,0,0,0,0,0,0
"2346","SJ Massiah ",2004,2004,2,2,0,0,0,0,0,0
"2347","PS Masvaure ",2018,2018,2,2,0,0,0,0,0,0
"2348","AW Mathieson ",2015,2015,1,1,0,0,0,0,0,0
"2349","BM Mauricette ",1979,1979,3,3,0,0,0,0,0,0
"2350","DES Maxwell ",2006,2007,10,10,0,0,0,0,0,0
"2351","Mazharul Haque ",2002,2002,1,1,0,0,0,0,0,0
"2352","GJ McCarter ",2014,2014,1,1,0,0,0,0,0,0
"2353","SC Meaker ",2011,2011,2,2,0,0,0,0,0,0
"2354","Mehmood Quaraishy ",1975,1975,3,3,0,0,0,0,0,0
"2355","PS Mehta ",1975,1975,1,1,0,0,0,0,0,0
"2356","MA Meman ",1987,1987,1,1,0,0,0,0,0,0
"2357","PHKD Mendis ",2019,2019,2,2,0,0,0,0,0,0
"2358","JM Mennie ",2016,2016,2,2,0,0,0,0,0,0
"2359","PL Mhambrey ",1996,1998,3,3,0,0,0,0,0,0
"2360","Mohammad Abbas ",2019,2019,3,3,0,0,0,0,0,0
"2361","Mohammad Aslam ",1996,1996,4,4,0,0,0,0,0,0
"2362","Mohammad Iqbal ",2007,2008,5,5,0,0,0,0,0,0
"2363","Mohammad Nazir ",1980,1984,4,4,0,0,0,0,0,0
"2364","Mohammad Talha ",2014,2014,3,3,0,0,0,0,0,0
"2365","Mohammed Siraj ",2019,2019,1,1,0,0,0,0,0,0
"2366","Moin-ul-Atiq ",1988,1989,5,5,0,0,0,0,0,0
"2367","Moniruzzaman ",2003,2003,2,2,0,0,0,0,0,0
"2368","DWO Morgan ",2006,2006,2,2,0,0,0,0,0,0
"2369","EA Moseley ",1990,1991,9,8,0,0,0,0,0,0
"2370","PV Mpitsang ",1999,1999,2,2,0,0,0,0,0,0
"2371","Mujahid Jamshed ",1997,1997,4,4,0,0,0,0,0,0
"2372","M Mulla ",2007,2007,1,1,0,0,0,0,0,0
"2373","AMN Munasinghe ",1994,1996,5,5,0,0,0,0,0,0
"2374","Munir Dar ",2008,2008,2,2,0,0,0,0,0,0
"2375","GB Murgatroyd ",2003,2003,6,6,0,0,0,0,0,0
"2376","DJ Murray ",1994,1994,1,1,0,0,0,0,0,0
"2377","T Muzarabani ",2015,2016,8,8,0,0,0,0,0,0
"2378","Nadeem Ghauri ",1990,1990,6,6,0,0,0,0,0,0
"2379","Nadeem Khan ",1993,1995,2,2,0,0,0,0,0,0
"2380","Naeem Ashraf ",1995,1995,2,2,0,0,0,0,0,0
"2381","J Nagenda ",1975,1975,1,1,0,0,0,0,0,0
"2382","SS Naik ",1974,1974,2,2,0,0,0,0,0,0
"2383","KK Nair ",2016,2016,2,2,0,0,0,0,0,0
"2384","Najaf Shah ",2007,2007,1,1,0,0,0,0,0,0
"2385","Najeeb Tarakai ",2017,2017,1,1,0,0,0,0,0,0
"2386","DP Nannes ",2009,2009,1,1,0,0,0,0,0,0
"2387","Naseer Malik ",1975,1975,3,3,0,0,0,0,0,0
"2388","Nasim-ul-Ghani ",1973,1973,1,1,0,0,0,0,0,0
"2389","Nasir Aziz ",2014,2015,5,5,0,0,0,0,0,0
"2390","Nasir Hameed ",2004,2004,1,1,0,0,0,0,0,0
"2391","Nasir Javed ",2004,2004,1,1,0,0,0,0,0,0
"2392","Naumanullah ",2008,2008,1,1,0,0,0,0,0,0
"2393","Naved Anjum ",1984,1992,13,13,0,0,0,0,0,0
"2394","MN Nawaz ",1998,2002,3,3,0,0,0,0,0,0
"2395","AM Nayar ",2009,2009,3,3,0,0,0,0,0,0
"2396","N Ncube ",2011,2011,1,1,0,0,0,0,0,0
"2397","A Ndlovu ",2019,2019,2,2,0,0,0,0,0,0
"2398","MG Neser ",2018,2018,2,2,0,0,0,0,0,0
"2399","SO Ngoche ",2010,2014,14,14,0,0,0,0,0,0
"2400","IA Nicolson ",2010,2010,2,2,0,0,0,0,0,0
"2401","RG Nijman ",2009,2009,1,1,0,0,0,0,0,0
"2402","AA Noffke ",2008,2008,1,1,0,0,0,0,0,0
"2403","Nurul Abedin ",1986,1990,4,4,0,0,0,0,0,0
"2404","KJ O'Keeffe ",1977,1977,2,2,0,0,0,0,0,0
"2405","D Olivier ",2019,2019,2,2,0,0,0,0,0,0
"2406","DR O'Sullivan ",1974,1976,3,3,0,0,0,0,0,0
"2407","MB Owens ",1992,1992,1,1,0,0,0,0,0,0
"2408","M Panchal ",2007,2007,1,1,0,0,0,0,0,0
"2409","GK Pandey ",1999,1999,2,2,0,0,0,0,0,0
"2410","BA Parchment ",2007,2008,7,7,0,0,0,0,0,0
"2411","MW Parkinson ",2020,2020,2,2,0,0,0,0,0,0
"2412","SD Parry ",2014,2014,2,2,0,0,0,0,0,0
"2413","Parvez Rasool ",2014,2014,1,1,0,0,0,0,0,0
"2414","NT Pascal ",2009,2009,1,1,0,0,0,0,0,0
"2415","SP Pasqual ",1979,1979,2,2,0,0,0,0,0,0
"2416","A Patel ",2003,2003,2,2,0,0,0,0,0,0
"2417","JM Patel ",1979,1979,3,3,0,0,0,0,0,0
"2418","KA Patel ",2006,2006,2,2,0,0,0,0,0,0
"2419","ML Patel ",2004,2006,3,3,0,0,0,0,0,0
"2420","RGM Patel ",1988,1988,1,1,0,0,0,0,0,0
"2421","R Pathan ",2013,2013,1,1,0,0,0,0,0,0
"2422","BMW Patterson ",1999,1999,3,3,0,0,0,0,0,0
"2423","GE Peckover ",1983,1983,3,3,0,0,0,0,0,0
"2424","KG Perera ",1986,1986,1,1,0,0,0,0,0,0
"2425","N Phillip ",1978,1978,1,1,0,0,0,0,0,0
"2426","HSM Pieris ",1975,1975,3,3,0,0,0,0,0,0
"2427","K Pierre ",2019,2020,3,3,0,0,0,0,0,0
"2428","ADJ Pitcher ",2007,2007,3,3,0,0,0,0,0,0
"2429","PI Pocock ",1985,1985,1,1,0,0,0,0,0,0
"2430","DJ Pringle ",1975,1975,2,2,0,0,0,0,0,0
"2431","CA Pujara ",2013,2014,5,4,0,0,0,0,0,0
"2432","Y Punja ",2015,2015,1,1,0,0,0,0,0,0
"2433","M Pushpakumara ",2009,2010,3,2,0,0,0,0,0,0
"2434","CT Radley ",1978,1978,4,4,0,0,0,0,0,0
"2435","Rafiqul Alam ",1986,1986,2,2,0,0,0,0,0,0
"2436","Rafiqul Islam ",2002,2002,1,1,0,0,0,0,0,0
"2437","RR Ramdass ",2005,2005,1,1,0,0,0,0,0,0
"2438","D Ramnarine ",1997,2001,4,4,0,0,0,0,0,0
"2439","DR Ramsammy ",2012,2012,1,1,0,0,0,0,0,0
"2440","Ramveer Rai ",2004,2004,1,1,0,0,0,0,0,0
"2441","AN Ranasinghe ",1975,1982,9,9,0,0,0,0,0,0
"2442","N Ranatunga ",1993,1993,2,2,0,0,0,0,0,0
"2443","Randhir Singh ",1981,1983,2,2,0,0,0,0,0,0
"2444","Rashid Zia ",2004,2004,2,2,0,0,0,0,0,0
"2445","NLK Ratnayake ",1989,1990,2,2,0,0,0,0,0,0
"2446","SS Raul ",1998,1998,2,2,0,0,0,0,0,0
"2447","Raza Hasan ",2014,2014,1,1,0,0,0,0,0,0
"2448","RE Redmond ",1973,1973,2,2,0,0,0,0,0,0
"2449","B Regmi ",2018,2019,4,4,0,0,0,0,0,0
"2450","CA Reid ",2004,2004,2,2,0,0,0,0,0,0
"2451","RA Reifer ",2019,2019,2,2,0,0,0,0,0,0
"2452","CEB Rice ",1991,1991,3,3,0,0,0,0,0,0
"2453","EJ Richardson ",2013,2013,2,2,0,0,0,0,0,0
"2454","EB Ringera ",2011,2011,1,1,0,0,0,0,0,0
"2455","HP Rinke ",2006,2006,18,18,0,0,0,0,0,0
"2456","Rizwan Latif ",2004,2004,1,1,0,0,0,0,0,0
"2457","SJ Roberts ",1990,1990,2,2,0,0,0,0,0,0
"2458","Robiul Islam ",2013,2013,3,3,0,0,0,0,0,0
"2459","TS Roland-Jones ",2017,2017,1,1,0,0,0,0,0,0
"2460","Saad Ali ",2019,2019,2,2,0,0,0,0,0,0
"2461","Saad Nasim ",2015,2015,3,3,0,0,0,0,0,0
"2462","Sagar Pun ",2018,2018,1,1,0,0,0,0,0,0
"2463","Saiful Islam ",1990,1997,7,7,0,0,0,0,0,0
"2464","Sajjad Ahmed ",1995,1995,2,2,0,0,0,0,0,0
"2465","Sajjad Akbar ",1990,1990,2,2,0,0,0,0,0,0
"2466","Saleem Pervez ",1980,1980,1,1,0,0,0,0,0,0
"2467","Saleem Raza ",1994,1996,6,6,0,0,0,0,0,0
"2468","Salman Faris ",2014,2014,3,3,0,0,0,0,0,0
"2469","Salman Farooq ",2014,2014,1,1,0,0,0,0,0,0
"2470","Samiullah Khan ",2008,2008,2,2,0,0,0,0,0,0
"2471","Sami Aslam ",2015,2016,4,4,0,0,0,0,0,0
"2472","Sami Faridi ",2008,2008,3,3,0,0,0,0,0,0
"2473","GS Sandhu ",2015,2015,2,2,0,0,0,0,0,0
"2474","Saqib Zulfiqar ",2019,2019,1,1,0,0,0,0,0,0
"2475","P Sarraf ",2019,2019,2,2,0,0,0,0,0,0
"2476","Sayed Shirzad ",2019,2019,2,1,0,0,0,0,0,0
"2477","RH Scholte ",2002,2003,5,5,0,0,0,0,0,0
"2478","BN Schultz ",1992,1992,1,1,0,0,0,0,0,0
"2479","GR Sealy ",1979,1979,3,3,0,0,0,0,0,0
"2480","TAP Sekhar ",1983,1985,4,4,0,0,0,0,0,0
"2481","Shafiuddin Ahmed ",1997,2000,11,11,0,0,0,0,0,0
"2482","Shaheedur Rahman ",1986,1986,2,2,0,0,0,0,0,0
"2483","Shahid Anwar ",1996,1996,1,1,0,0,0,0,0,0
"2484","Shehzad Altaf ",1996,1996,2,2,0,0,0,0,0,0
"2485","Shahzad Khan ",2007,2007,1,1,0,0,0,0,0,0
"2486","Shahzaib Hasan ",2010,2010,3,3,0,0,0,0,0,0
"2487","Shakeel Ahmed jnr ",1995,1995,2,2,0,0,0,0,0,0
"2488","Shakeel Khan ",1987,1987,1,1,0,0,0,0,0,0
"2489","A Shamshudeen ",2007,2007,1,1,0,0,0,0,0,0
"2490","JNK Shannon ",2013,2013,1,1,0,0,0,0,0,0
"2491","Shariful Haque ",1998,1998,1,1,0,0,0,0,0,0
"2492","PH Sharma ",1976,1976,2,2,0,0,0,0,0,0
"2493","PP Shaw ",2020,2020,3,3,0,0,0,0,0,0
"2494","AP Sheahan ",1972,1972,3,3,0,0,0,0,0,0
"2495","Sheikh Salahuddin ",1997,1997,6,6,0,0,0,0,0,0
"2496","V Shetty ",2008,2014,2,2,0,0,0,0,0,0
"2497","M Shezi ",2014,2014,1,1,0,0,0,0,0,0
"2498","S Shivnarine ",1978,1978,1,1,0,0,0,0,0,0
"2499","Shubman Gill ",2019,2019,2,2,0,0,0,0,0,0
"2500","Shuvagata Hom ",2011,2011,4,4,0,0,0,0,0,0
"2501","JD Siddons ",1988,1988,1,1,0,0,0,0,0,0
"2502","EHSN Silva ",2008,2008,1,1,0,0,0,0,0,0
"2503","KJ Silva ",1995,1995,1,1,0,0,0,0,0,0
"2504","CEW Silverwood ",1996,2001,7,7,0,0,0,0,0,0
"2505","Simandeep Singh ",2018,2018,1,1,0,0,0,0,0,0
"2506","RP Singh ",1986,1986,2,2,0,0,0,0,0,0
"2507","Skhawat Ali ",2008,2014,4,4,0,0,0,0,0,0
"2508","WN Slack ",1986,1986,2,2,0,0,0,0,0,0
"2509","CL Smith ",1984,1984,4,4,0,0,0,0,0,0
"2510","DM Smith ",1986,1990,2,2,0,0,0,0,0,0
"2511","M Smith ",2008,2008,1,1,0,0,0,0,0,0
"2512","MJ Smith ",1999,1999,5,5,0,0,0,0,0,0
"2513","RAJ Smith ",2016,2016,2,2,0,0,0,0,0,0
"2514","G Snyman ",2003,2003,5,5,0,0,0,0,0,0
"2515","Sohail Butt ",1994,1994,2,2,0,0,0,0,0,0
"2516","S Somasunder ",1996,1996,2,2,0,0,0,0,0,0
"2517","TE Srinivasan ",1980,1981,2,2,0,0,0,0,0,0
"2518","RW Staple ",2004,2004,2,2,0,0,0,0,0,0
"2519","NA Statham ",2003,2009,3,3,0,0,0,0,0,0
"2520","MP Stead ",1979,1979,2,2,0,0,0,0,0,0
"2521","RD Steede ",2006,2008,8,8,0,0,0,0,0,0
"2522","DS Steele ",1976,1976,1,1,0,0,0,0,0,0
"2523","SL Stewart ",2010,2010,4,4,0,0,0,0,0,0
"2524","PJR Steyn ",1995,1995,1,1,0,0,0,0,0,0
"2525","OP Stone ",2018,2018,4,3,0,0,0,0,0,0
"2526","Subashis Roy ",2016,2016,1,1,0,0,0,0,0,0
"2527","Sultan Ahmed ",2019,2019,2,2,0,0,0,0,0,0
"2528","GP Sulzberger ",2000,2000,3,3,0,0,0,0,0,0
"2529","S Sumar ",1975,1975,1,1,0,0,0,0,0,0
"2530","Sunzamul Islam ",2017,2018,3,3,0,0,0,0,0,0
"2531","SJ Swanepoel ",2003,2003,5,5,0,0,0,0,0,0
"2532","Tabarak Dar ",2004,2008,4,4,0,0,0,0,0,0
"2533","AR Tait ",1998,1999,5,5,0,0,0,0,0,0
"2534","Tanvir Mehdi ",1992,1992,1,1,0,0,0,0,0,0
"2535","Tariq Javed ",1979,1979,3,3,0,0,0,0,0,0
"2536","JP Taylor ",1993,1993,1,1,0,0,0,0,0,0
"2537","LB Taylor ",1986,1986,2,2,0,0,0,0,0,0
"2538","DJ Terbrugge ",2000,2000,4,4,0,0,0,0,0,0
"2539","DJ ter Braak ",2018,2018,2,2,0,0,0,0,0,0
"2540","VAB Tewarie ",2011,2011,1,1,0,0,0,0,0,0
"2541","JG Thomas ",1986,1987,3,3,0,0,0,0,0,0
"2542","O Thomas ",2018,2020,20,19,0,0,0,0,0,0
"2543","EP Thompson ",2009,2009,1,1,0,0,0,0,0,0
"2544","PIC Thompson ",1997,1997,2,2,0,0,0,0,0,0
"2545","AL Thomson ",1971,1971,1,1,0,0,0,0,0,0
"2546","MH Tissera ",1975,1975,3,3,0,0,0,0,0,0
"2547","GC Tonge ",2009,2009,5,5,0,0,0,0,0,0
"2548","PM Toohey ",1978,1979,5,4,0,0,0,0,0,0
"2549","GS Trimble ",1986,1986,2,2,0,0,0,0,0,0
"2550","MS Tshabalala ",2007,2007,4,4,0,0,0,0,0,0
"2551","CK Tshuma ",2020,2020,2,2,0,0,0,0,0,0
"2552","CM Tuckett ",1998,1998,1,1,0,0,0,0,0,0
"2553","ML Udawatte ",2008,2008,9,9,0,0,0,0,0,0
"2554","JD Unadkat ",2013,2013,7,7,0,0,0,0,0,0
"2555","Usman Mushtaq ",2015,2015,1,1,0,0,0,0,0,0
"2556","T van der Gugten ",2012,2013,4,4,0,0,0,0,0,0
"2557","MG Vandort ",2006,2006,1,1,0,0,0,0,0,0
"2558","PA van Meekeren ",2013,2019,5,5,0,0,0,0,0,0
"2559","MWA van Nierop ",2006,2006,2,2,0,0,0,0,0,0
"2560","KJJ van Noortwijk ",1996,2003,9,9,0,0,0,0,0,0
"2561","BO van Rooi ",2003,2003,3,3,0,0,0,0,0,0
"2562","RJ van Vuuren ",2003,2003,5,5,0,0,0,0,0,0
"2563","CJPG van Zyl ",1992,1992,2,2,0,0,0,0,0,0
"2564","JCB Vaughan ",1979,1979,3,3,0,0,0,0,0,0
"2565","M Venkataramana ",1988,1988,1,1,0,0,0,0,0,0
"2566","GE Vivian ",1973,1973,1,1,0,0,0,0,0,0
"2567","DM Vonhagt ",1985,1985,1,1,0,0,0,0,0,0
"2568","Wahidul Gani ",1988,1988,1,1,0,0,0,0,0,0
"2569","KP Walmsley ",2003,2003,2,2,0,0,0,0,0,0
"2570","R Walters ",2003,2003,2,2,0,0,0,0,0,0
"2571","S Walusimbi ",1975,1975,3,3,0,0,0,0,0,0
"2572","Waqas Khan ",2015,2017,8,8,0,0,0,0,0,0
"2573","Wasim Haider ",1992,1992,3,3,0,0,0,0,0,0
"2574","SL Watkin ",1994,1994,4,4,0,0,0,0,0,0
"2575","M Watkinson ",1996,1996,1,1,0,0,0,0,0,0
"2576","GD Watson ",1972,1972,2,2,0,0,0,0,0,0
"2577","RJ Webb ",1983,1983,3,3,0,0,0,0,0,0
"2578","AP Weerakkody ",1994,1994,1,1,0,0,0,0,0,0
"2579","S Weerakoon ",2012,2012,2,2,0,0,0,0,0,0
"2580","AP Wells ",1995,1995,1,1,0,0,0,0,0,0
"2581","CM Wells ",1985,1985,2,2,0,0,0,0,0,0
"2582","MD Wettimuny ",1983,1983,1,1,0,0,0,0,0,0
"2583","SRD Wettimuny ",1975,1979,3,3,0,0,0,0,0,0
"2584","K Whatham ",2011,2011,1,1,0,0,0,0,0,0
"2585","DF Whatmore ",1980,1980,1,1,0,0,0,0,0,0
"2586","RK Whelan ",2007,2007,2,2,0,0,0,0,0,0
"2587","RPAH Wickramaratne ",1993,1993,3,3,0,0,0,0,0,0
"2588","D Wiese ",2015,2016,6,6,0,0,0,0,0,0
"2589","KOK Williams ",2017,2018,8,8,0,0,0,0,0,0
"2590","JG Williamson ",1999,1999,2,2,0,0,0,0,0,0
"2591","CM Willoughby ",2000,2003,3,3,0,0,0,0,0,0
"2592","AJ Woodcock ",1974,1974,1,1,0,0,0,0,0,0
"2593","LJ Woodcock ",2011,2011,4,4,0,0,0,0,0,0
"2594","T Yohannan ",2002,2002,3,3,0,0,0,0,0,0
"2595","Yunus Badat ",1975,1975,2,2,0,0,0,0,0,0
"2596","Zafar Gohar ",2015,2015,1,1,0,0,0,0,0,0
"2597","Zaheer Maqsood ",2015,2015,2,2,0,0,0,0,0,0
"2598","Zahid Ahmed ",1987,1987,2,2,0,0,0,0,0,0
"2599","Zahid Razzak ",1988,1990,3,3,0,0,0,0,0,0
"2600","Zahid Shah ",2008,2008,2,2,0,0,0,0,0,0
"2601","MZ Zahir ",2009,2009,1,1,0,0,0,0,0,0
"2602","Zahir Khan ",2019,2019,1,1,0,0,0,0,0,0
"2603","Zain Abbas ",2008,2008,1,1,0,0,0,0,0,0
"2604","Zakir Hasan ",1997,1997,1,1,0,0,0,0,0,0
"2605","Zakir Hossain ",1998,1998,1,1,0,0,0,0,0,0
"2606","Zakir Khan ",1984,1990,17,16,0,0,0,0,0,0
"2607","Zakiullah Zaki ",2012,2012,1,1,0,0,0,0,0,0
"2608","Zawar Farid ",2020,2020,1,1,0,0,0,0,0,0
"2609","Zeeshan Siddiqi ",2012,2014,2,2,0,0,0,0,0,0
"2610","Zulfiqar Babar ",2014,2015,5,5,0,0,0,0,0,0
"2611","BC Fortuin ",2020,2020,1,NA,NA,NA,NA,NA,NA,NA
